#-*- mode: mandoku-view; -*-
#+DATE: 2009/03/08 
#+TITLE: Taisho Tripitaka, Electronic version, No. 2076 景德傳燈錄
#+PROPERTY: ID T51n2076
#+PROPERTY: SOURCE Taisho Tripitaka Vol. 51, No. 2076
#+PROPERTY: BASEEDITION T
#+PROPERTY: WITNESS 【CBETA】
#+PROPERTY: LASTPB <pb:ZB6q0003_T_005-0235a>¶¶¶¶¶¶¶¶¶
#+PROPERTY: JUAN 5
¶¶景德傳燈錄卷第五


¶¶
  
  * 第三十三祖慧能大師¶
  * 第三十三祖慧能大師法嗣四十三人¶
  
  * 西印度堀多三藏
  * 韶州法海禪師¶
  * 吉州志誠禪師
  * 匾檐山曉了禪師¶
  * 河北智隍禪師
  * 洪州法達禪師¶
  * 壽州智通禪師
  * 江西志徹禪師¶
  * 信州智常禪師
  * 廣州志道禪師¶
  * 廣州法性寺印宗和尚¶
  * 吉州青原山行思禪師¶
  * 南嶽懷讓禪師
  * 溫州永嘉玄覺禪師¶
  * 司空山本淨禪師
  * 婺州玄策禪師¶
  * 曹谿令韜禪師
  * 西京光宅寺慧忠禪師¶
  * 西京荷澤寺神會禪師
(已上一十九人見錄)¶
  * 韶州祇陀禪師
  * 撫州淨安禪師¶
  * 嵩山尋禪師
  * 羅浮山定真禪師¶
  * 南嶽堅固禪師
  * 制空山道進禪師¶
  * 善快禪師
  * 韶山緣素禪師
<pb:ZB6q0003_T_005-0235b>
¶
  * 宗一禪師
  * 會稽秦望山善現禪師¶
  * 南嶽梵行禪師
  * 并州自在禪師¶
  * 西京咸空禪師
  * 峽山泰祥禪師¶
  * 光州法淨禪師
  * 清涼山辯才禪師¶
  * 廣州吳頭陀
  * 道英禪師¶
  * 智本禪師
  * 廣州清苑法真禪師¶
  * 玄楷禪師
  * 曇璀禪師¶
  * 韶州刺史韋據¶
  * 義興孫菩薩
(已上二十四人無機緣語句不錄)¶

*** 第三十三祖慧能大師者	33. Patriarch Großmeister Huineng
第三十三祖慧能大師者，	Großmeister Huinengs
俗姓盧氏，	Familienname war Lu und 
其先范¶陽人。	sein Heimatort war Fanyang.
父行瑫，	Sein Vater Xingtao wurde
武德中，	während der Ära Wude [der Tang Dynastie]
左宦于南海。	als Verwalter in die Regionen des Südlichen Meers geschickt
之新州，遂¶占籍焉。	und siedelte schließlich offiziell in Xinzhou.
三歲喪父，	Im Alter von drei Jahren verlor er den Vater,
其母守志鞠養。	und obwohl seine Mutter sich sehr um eine angemessene Erziehung der Kinder bemühte,
及長，家尤¶貧窶，	war die Familie doch bitterarm, als er das Mannesalter erreichte.

師樵采以給。	Huineng unterstützte seine Familie indem er Feuerholz sammelte.
一日，負薪至市中，	Eines Tages, als er gerade eine Ladung Feuerholz zum Markt brachte,
聞客讀《¶金剛經》，	hörte er einen seiner Kunden das /Diamant Sutra/ rezitieren.
悚然問其客曰︰	Er war sehr betroffen und fragte den Kunden:
「此何法也？	"Was ist das für eine Lehre?
得於何人？」	Von wem hast du sie bekommen?"

¶客曰︰	Der Kunde antwortete:
「此名《金剛經》，	"Das ist das /Diamant Sutra/,
得於黃梅忍大師。」	ich habe es von Meister Hongren vom Huangmei Berg."
師遽告¶其母以為法尋師之意。	Huineng eilte nach Hause und erzählte seiner Mutter, daß er die Absicht habe, um dieser Lehre willen nach einem Lehrer zu suchen.

直抵韶州，	Er ging direkt nach Shaozhou,
遇高行士¶劉志略，	wo er einen Mann von gutem Ruf namens Liu Zhilüe traf
結為交友。	und Freundschaft mit ihm schloß.
尼無盡藏者，	Dieser hatte eine Tante, die eine Nonne von unerschöpflicher Tugend war,
即志略之姑¶也，
常讀《涅槃經》，	die pflegte das /Nirvaṇa Sūtra/ zu lesen.
師暫聽之，	Nachdem Huineng eine Weile zugehört hatte,
即為解說其義，	erklärte er ihr die Bedeutung des Sutras.
尼¶遂執卷問字，	Die Nonne zeigte ihm nun die Schriftrolle selbst und fragte ihn nach der Bedeutung bestimmter Zeichen.
師曰︰	Da sagte Huineng:
「字即不識，	"Ich kenne keine Zeichen,
義即請問。」	aber die Bedeutung des Textes will ich gerne erläutern."

尼¶曰︰	Die Nonne sagte:
「字尚不識，	"Aber wenn du nicht einmal die Zeichen verstehst,
曷能會義？」	wie kannst du die Bedeutung des Textes verstehen?"

師曰︰	Huineng sagte:
「諸佛妙理，	"Die wunderbare Lehre Buddhas
非關¶文字。」	hängt nicht von Schriftzeichen ab."

尼驚異之，	Die Nonne war sehr überrascht und wunderte sich,
告鄉里耆艾云︰	und sprach zu den Älteren des Dorfes:
「能是有道之¶人，	"Huineng ist jemand, der den Weg versteht,
宜請供養。」	wir sollten ihm Ehre erweisen."


於是居人競來瞻禮。	So kam es, daß die Einwohner des Dorfes sehr begierig waren, ihm ihre Aufwartung zu machen und Ehrenbezeigungen zu erweisen.
##hier heisst das wohl eher, 'sich um ihn kümmern'
近有寶林¶古寺舊地，	In der Nähe war die Ruine des alten Baolin Tempels,
眾議營緝，	sie beschlossen ihn zu reparieren,
俾師居之。	sodaß Huineng dort leben konnte.
四眾霧集，	Mönche, Nonnen, Männer und Frauen sammelten sich wie Wolken
俄¶成寶坊。	und so wurde der Baolin Tempel [wieder]gegründet.
師一日忽自念曰︰	Einese Tages sagte Huineng zu sich selbst:
「我求大法，	"Ich suche nach der großen Lehre,
豈可中¶道而止？」	warum sollte ich auf halbem Wege Halt machen?"
明日遂行。	Und so ging er am nächsten Tage davon.

至昌樂縣西山石室間，	Er gelangte nach Changle, wo er in den Höhlen der westlichen Berge
遇¶智遠禪師。	Chan Meister Zhiyuan traf,
師遂請益，	den er um Rat bat.
遠曰︰	Zhiyuan sagte:
「觀子神姿爽拔，	"Ich sehe ihren ungewöhnliche Gestalt und Haltung
殆¶非常人。	und erkenne, daß Sie kein gewöhnlicher Mensch sind.
吾聞西域菩提達磨。	Ich hörte, daß ein Meister aus den westlichen Gebieten namens Bodhidharma
傳心印于黃梅，	das Siegel seines Geistes dem Meister am Huangmei Berg übertragen hat.
¶汝當往彼參決。」	Ich rate Ihnen, gehen sie dorthin und studieren Sie bei ihm."

師辭去，	Huineng bedankte sich und
直造黃梅之東禪，	ging direkt zum Dongchan Tempel amd Huangmei Berg,
即¶唐咸亨二年也。	dorthin gelangte er im 2. Jahr der Ära Xianheng der Tang Dynastie
:zhu:
咸亨二 [xian2xiang3er4] 671
:end:
忍大師一見，	Großmeister Hongren sah ihn an
默而識之，	und erkannte mit einem Blick [seine ungewöhnliche Begabung].
後傳<pb:ZB6q0003_T_005-0235c>¶衣法，	Später übertrug er ihm Robe und Dharma,
令隱于懷集、	und befahl ihm, sich in Huaiji zu verstecken,
四會之間。	sodaß es zunächst in seiner Versammlung nicht bekannt wurde.

至儀鳳元年丙¶子正月八日，	Am 8. Tag des ersten Monats im 1. Jahr der Ära Yifeng
屆南海，	gelangte er an die südliche Küste,
遇印宗法師於法性寺¶講《涅槃經》，	wo er den Ehrenwerten Yinzong traf, der im Faxing Tempel über das /Nirvaṇa Sūtra/ predigte.
師寓止廊廡間。	Während er dort war lebte er in einer Zelle in der Nähe des überdachten Verbindungsgang.
暮夜，	Bei Einbruch der Dämmerung
風颺剎幡，	erhobe sich ein Wind und bewegte das Tempelbanner.
:zhu:
剎幡 [sha1fan1]  Tempelbanner
:end:
聞¶二僧對論，	Er hörte, wie sich zwei Mönche darüber unterhielten,
一云幡動，	der eine sagte, die Fahne bewege sich,
一云風動，	der andere sagte, es sei der Wind, der sich bewege.
往復酬答，	So ging der Streit hin und her
未¶曾契理。	und keiner behielt die Oberhand.
師曰︰	Da sagte Huineng:
「可容俗流輒預高論否？	"Erlauben Sie einem einfachen Mann Ihre gelehrte Diskussion zu unterbrechen?
直以風¶幡非動，	Es bewegen sich weder Wind noch Fahne,
動自心耳。」	sondern es ist einzig Euer Geist, der sich bewegt."

印宗竊聆此語，	Als Yinzong von diesem Gespräch hörte 
竦然異之。	war er sehr erstaunt.
¶翌日，	Am nächsten Tag
邀師入室，	ließ er Huineng in sein Zimmer rufen
徵風幡之義。	und fragte ihn nach dem Vorfall von Wind und Fahne.
師具以理告，	Huineng berichtete ihm davon und
印¶宗不覺起立云︰	Yinzong stand unvermittelt auf und rief:
「行者定非常人，	"Sie sind sicherlich ein außergewöhnlicher Mann,
師為是誰？」	Meister, wer sind Sie denn?"
師¶更無所隱，	Nun offenbarte ihm Huineng was sich ereignet hatte und 
直敘得法因由。	erzählte ihm, daß er von Hongren die Übertragung der Lehre erhalten hatte.

於是印宗執弟子¶之禮，	Nun bat ihn Yinzong, ihn als Schüler anzunehmen, vollzog das notwendige Ritual und
請受禪要，	bat ihn, ihn die Essenz des Chan zu lehren.
乃告四眾曰︰	Dann sagte er vor der Versammlung der Mönche, Nonnen, Männer und Frauen:
「印宗具足凡夫，	"Yinzong ist nur ein gewöhnlicher Mann,
¶今遇肉身菩薩。」	aber heute bin ich einem Fleisch gewordenen Bodhisattva begegnet!"
即指坐下盧居士云︰	Er wies auf den Laienbruder Lu, der sich in der Versammlung befand und sagte:
「即此是¶也。」	"Dies ist der Mann."
因請出所傳信衣，	Und er bat, daß alle in der Versammlung Gelegenheit bekämen,
悉令瞻禮。	die Robe der Übertragung zu sehen und sich vor ihr zu verbeugen.


至正月十五¶日，	Am 15. Tag des ersten Monats
會諸名德，	ließ Yinzong alle altgedienten Mönche des Tempels sich versammeln
為之剃髮。	und vollzog das rituelle Abschneiden der Haare.
二月八日，	Am 8. Tag des 2. Monats
就法性寺¶智光律師受滿分戒，	wurden ihm im Faxing Tempel durch Vinaya Meister Zhiguang die vollen Ordensregeln gegeben.

其戒壇即宋朝求那跋¶陀三藏之所置也，	Die Ordensplattform, die dafür benutzt wurde war die in der [früheren] Song Dynastie von Guṇabhadra errichtete Plattform.
三藏記云︰	Dieser hatte damals vorausgesagt:
「後當有肉身菩¶薩在此壇受戒。」	"In der Zukunft wird hier die Inkarnation eines Bodhisattva die Ordination empfangen."
又梁末真諦三藏。	Später, gegen Ende der Liang Dynastie, hatte Paramārtha
於壇之側，	neben der Plattform
¶手植二菩提樹，	zwei Bodhi Bäume gepflanzt
謂眾曰︰	und gesagt:
「却後一百二十年，	"In 120 Jahren
有¶大開士。	wird ein großer Meister
於此樹下演無上乘，	unter diesen Bäumen über das große Fahrzeug predigen
度無量眾。」	und unzählige Menschen aus der [Gebundenheit durch Unwissenheit] befreien.
師具¶戒已，	Nachdem er die Ordination empfangen hatte,
於此樹下開東山法門，	predigte Huineng unter diesen Bäumen die Lehre vom östlichen Berg,
宛如宿契。	genauso, wie es diese Prophezeiungen vorausgesagt hatten.

明年¶二月八日，	Im folgenden Jahr am 8. Tag des 2. Monats
忽謂眾曰︰	sagte Huineng plötzlich
「吾不願此居，	"Ich kann hier nicht weiter wohnen bleiben,
要歸舊隱。」	sondern wünsche zu meinem alten Tempel zurückzukehren."
¶時印宗與緇白千餘人。	So kam es daß Yinzong mit mehr als tausend Mönchen, 
送師歸寶林寺。	ihn bei seiner Abreise zum Baolin Tempel verabschiedeten.
**** 
韶州¶刺史韋據請於大梵寺轉妙法輪，	Weiju, der Gouverneur von Shaozhou, bat Huineng am Dafan Tempel das Dharma Rad zu drehen.
并受無相¶心地戒，	Bei der Gelegenheit erhielt der Gouverneur auch die formlosen Gebote der Lehre vom Geistesgrund.
:zhu:
無相心地戒 [wu2xiang4xin1di4jie4] ein anderer Name für die Bodhisattva-Präzepte
:END:

門人紀錄，	Die Schüler von Huineng zeichneten seine Predigten auf
目為《壇經》，	und unter dem Namen /Plattform Sutra/
盛行於世。	wurde es weit verbreitet.

然返¶曹谿，	Als er nach Caoxi zurückkam 
雨大法雨，	verbreitete er den großen Dharma-Regen für alle
學者不下千數。	und die Zahl der unter ihm studierenden war nicht unter Tausend.
**** 
中宗神龍元¶年，	Im 1. Jahr der Ära Shenlong, erließ Kaiser Zhongzong ein Edikt,
降詔云︰		darin hieß es:
「朕請安、	"Ich, der Kaiser, habe die beiden Ehrwürdigen [Hui]an und 
秀二師宮中供養，	[Shen]xiu gebeten an den Hof zu kommen und dort Ehren zu empfangen,
萬機之¶暇，	damit ich, soweit es die Affären des Staates erlauben,
每究一乘。	mehr über die Lehre des Einen Fahrzeugs erfahren kann.
二師並推讓云︰	Beide Meister lehnten aber voller Bescheidenheit ab und sagten:
『南方有能禪師，	'Im Süden gibt es den Chan Meister Huineng,
¶密受忍大師衣法，	der heimlich von Großmeister Hongren die Übertragung der Robe und Lehre erhalten hat,
可就彼問。』	wir empfehlen höflichst, ihn zu bitten.'
今遣內侍薛簡¶馳詔迎請，	So sende ich nun einen kaiserlichen Gesandten Xue Jian und hoffe, daß meiner Bitte stattgegeben wird,
願師慈念，	ich bitte Sie, verehrter Meister, haben sie Mitleid,
速赴上京。」	folgen sie meinem Boten und kommen Sie in die Hauptstadt."
師上表辭疾，	Huineng führte seine Krankheit als Grund an und
¶願終林麓。	bat darum, seine Tage in seiner Klause im Wald beenden zu dürfen.

薛簡曰︰	Xue Jian sagte:
「京城禪德皆云︰	"Alle Chan Meister in der Hauptstadt sagen:
『欲得會道，	'Wer wünscht, in Einklang mit dem Weg zu gelangen,
<pb:ZB6q0003_T_005-0236a>
¶必須坐禪習定。	der muß unbedingt die Übung der sitzenden Meditation praktizieren.
若不因禪定而得解脫者，	Es gibt niemanden, der jemals die Befreiung erreicht hat, ohne das tiefe Samadhi zu praktizieren.'
未¶之有也。』	
未審師所說法如何？」	Bitte sagen Sie mir, verehrter Meister, was ist Ihre Lehre?"


師曰︰	Huineng sagte:
「道由心悟，	"Der Weg ist die Erleuchtung des Geistes,
¶豈在坐也？	wie könnte man das durch Sitzen erreichen?
經云︰	Im Sūtra heißt es:
:zhu:
經云 [jing4yun2] // [[mandoku:cbeta:T08n0235:0752b04][金剛般若波羅蜜經 T08n0235:0752b04]]
「須菩提！若有人言：『如來若來若去、若坐若¶
臥。』是人不解我所說義。何以故？如來者，無¶
所從來，亦無所去，故名如來。¶
:END:
『若見如來若坐若臥，	'Wer denkt, daß der Tathāgata manchmal sitzt und manchmal liegt,
是行邪¶道。	der ist auf dem Holzweg.
何故？	Warum ist das so?
無所從來，	Er hat keinen Ort von dem er kommt,
亦無所去。』	und auch keinen Ort zu dem er geht.'
若無生滅，	Wenn man frei ist von Werden und Vergehen,
是如¶來清淨禪；	dann ist das das reine Chan des Tathāgata.
諸法空寂，	Alle Dharmas sind leer,
是如來清淨坐。	das ist das reine Sitzen des Tathāgata.
究竟無¶證，	Darüber hinaus gibt es keinen Beweis,
豈況坐耶？」	wie könnte es also etwas wie 'Sitzen' geben?"

簡曰︰	Xue Jian sagte:
「弟子之迴，	"Wenn ich zurück bin,
主上必問，	wird mich mein Herr fragen,
願和¶尚慈悲指示心要。」	daher bitte ich Sie, Ehrwürden, haben Sie Mitleid und erklären Sie mir die Essenz Ihrer Lehre vom Geist."

師曰︰	Huineng sagte:
「道無明暗，	"Im Weg gibt es kein Hell und Dunkel,
明暗是代¶謝之義，	denn Hell und Dunkel sind einander entgegengesetzt.
明明無盡，	Helligkeit hat ganz offenbar keine Grenzen
亦是有盡。」	und doch kann man sagen, daß sie Grenzen hat."

簡曰︰	Xue Jian fragte:
「明喻智慧，	"Helligkeit symbolisiert die Weisheit
¶暗況煩惱，	und Dunkelheit den Zustand der Verwirrung.
修道之人儻不以智慧照破煩惱，	Wenn diejenigen, die eine Übung praktizieren nicht mit der Weisheit die Verwirrung zerstören,
¶無始生死憑何出離？」	wie können sie dann aus dem [Kreislauf] von Geburt und Tod ausbrechen, der seit Anbeginn besteht?"

師曰︰	Huineng sagte:
「若以智慧照煩惱¶者，	"Wenn man mit Weisheit die Verwirrung beleuchten würde,
此是二乘小兒、	so benähme man sich die die beiden Kinder, die [im Gleichnis des Lotus Sutra] in den beiden Wagen fahren,
羊鹿等機，	einer vom Schaf, der andere von einem Reh gezogen,
上智大根悉不如¶是。」	Diejenigen, deren Weisheit einer höheren Wurzel entstammt gehen so nicht vor."

簡曰︰	Xue Jian fragte:
「如何是大乘見解？」	"Was ist denn dann die Sichtweise des Großen Fahrzeugs?"

師曰︰	Huineng sagte:
「明與無明，	"Helligkeit und Nicht-Helligkeit,
其¶性無二，	sind in ihrer Natur nicht unterschieden.
無二之性即是實性。	Diese Nicht-Dualität ist ihre wahre Natur.
實性者，	Diese wahre Natur
處凡愚¶而不減，	ist allen gemein, sie nimmt bei Idioten nicht ab
在賢聖而不增，	und auch bei Weisen nicht zu.
住煩惱而不亂，	Auch wenn man sich im Stadium der Verwirrung befindet, ist sie nicht durcheinander,
居禪¶定而不寂，	wenn man in tiefster Versenkung des Chan ist, dann ist sie dennoch nicht in Ruhe.
不斷不常，	Sie ist nicht veränderlich und auch nicht unveränderlich,
不來不去，	sie kommt nicht und geht nicht,
不在中間，	und ist auch nicht in der Mitte dazwischen.
及¶其內外，	Sie ist nicht drinnen und auch nicht draußen,
不生不滅，	wird nicht und vergeht nicht,
性相如如，	ihre Natur und Form ist so wie sie ist
常住不遷，	ewig und unveränderlich,
名之¶曰道。」	dies ist es, was man 'Weg' (Dao) nennt."

簡曰︰	Xue Jian fragte:
「師說不生不滅，	"Was ist der Unterschied zwischen dem 'nicht werden und nicht vergehen' von dem Sie sprechen
何異外道？」	und dem der Häretiker?"


師曰︰	Huineng antwortete:
「外¶道所說不生不滅者，	"Was die Häretiker meinen, wenn sie sagen 'es gibt kein Werden und kein Vergehen',
將滅止生，	bedeutet das Vergehen das Ende des Werdens ist und
以生顯滅，	das Werden Vergehen zum Vorschein bringt.
滅¶猶不滅，	Vergehen heißt dann nicht vollkommene Auslöschung,
生說無生；	und Werden wird als Nicht-Werden erklärt.
我說不生不滅者，	Wenn ich dagegen von 'nicht Werden und nicht Vergehen' spreche,
本自無¶生，	dann heißt das, daß es ursprünglich, von Anfang an, kein Werden gab
今亦無滅，	und daß es ebensowenig ein Vergehen gibt,
所以不同外道。	hier ist ein Unterschied zu dem, was die Häretiker sagen.
汝若欲知心要，	Wenn du wirklich wissen möchtest, was die Essenz des Geistes ist,
¶但一切善惡都莫思量，	dann ist alles was du tun mußt einfach aufhören, in Kategorien von Gut und Böse zu denken,
自然得入清淨心體，	dann wirst du von alleine die reine Essenz von Geist und Körper eintreten,
¶湛然常寂，	und Körper und Geist werden in vollkommener Ruhe sein,
妙用恒沙。」	während Funktionen zahlreich wie Sand am Ufer des Ganges aufs wunderbarste sich manifestieren."

簡蒙指教，	Als Xue Jian diese Unterweisungen hörte,
豁然大悟，	erfuhr er plötzlich die große Erleuchtung,
禮¶辭歸闕。	er verbeugte sich tief und verließ den Meister.
表奏師語，	[Zurück in der Hauptstadt] verfaßte er einen Bericht über die Worte von Huineng.
有詔謝師，	Ein kaiserliches Edikt dankte ihm,
并賜磨衲袈裟、	sprach ihm eine purpurne Robe zu,
¶絹五百匹、	sowie fünfhundert Rollen Seide
寶鉢一口。	und eine wertvolle Schale.

十二月十九日，	Am 19. Tag des 12. Monats [desselben Jahres]
勅改古¶寶林為中興寺。	wurde durch kaiserlichen Befehl der Baolin Tempel ind Zhongxing Tempel umbenannt.
三年十一月十八日，	Am 18. Tag des 11. Monats 
又勅韶¶州刺史。	wurde der Gouverneur von Shaozhou angewiesen,
重加崇飾，	den Tempel noch einmal zu renovieren,
賜額為法泉寺，	diesmal wurde eine Tafel mit dem Namen Faquan Tempel aufgehängt.
師新州舊¶居為國恩寺。	Die alte Wohnstätte von Huineng wurde in Guoen Tempel umbenannt.
:zhu:
國恩寺 [guo2en1si4] : Tempel dem der Staat Dankbarkeit schuldet
:end:
**** 
一日，	Eines Tages
師謂眾曰︰	sprach er zu seiner Versammlung:
「諸善知識！	"Versammelte Freunde,
汝等¶各各淨心，	Jeder einzelne von Euch reinige seinen Geist
聽吾說法︰	und höre meiner Predigt zu.
汝等諸人，	Ihr alle besitzt
自心是佛，	einen Geist, der identisch ist mit dem Geist Buddhas,
更¶莫狐疑，	zweifelt nicht daran, wie es ein Fuchsgeist tun würde.
:zhu:
狐疑 [hu2yi2] zweifeln; vielleicht zu starke Übersetzung
:end:
外無一物而能建立，	Es gibt außerhalb nicht, daß aufgestellt werden könnte,
皆是本心生萬<pb:ZB6q0003_T_005-0236b>¶種法。	ihr alle seid dieser ursprüngliche Geist, der alle Dinge hervorbringt.
故經云︰	Daher heißt es im Sutra:
『心生種種法生，	'Wenn der Geist entsteht, dann enstehen alle Dinge,
心滅種種法滅。』	wenn der Geist verschwindet, dann verschwinden alle Dinge.'

¶若欲成就種智，	Wenn ihr wünscht, die Samen der Weisheit zu voller Frucht zu bringen,
須達一相三昧、	dann müßt ihr das Samādhi der Einen Form erreichen,
一行三昧。	oder die Konzentration auf Eine Handlung.
若¶於一切處而不住相，	Um frei zu werden von jeglicher Anhaftung,
彼相中不生憎愛，	das heißt, daß selbst innerhalb der Welt der Formen kein Haß und keine Liebe entstehen,
亦無¶取捨，	daß es kein Annehmen und Wegwerfen gibt,
不念利益成壞等事，	daß man nicht daran denkt, wie man aus irgendetwas Gewinn ziehen kann,
安閑恬靜，	keine friedliche und ruhige Ausgeglichenheit,
虛融澹¶泊，	keine Faulheit und kein Desinteresse,
此名一相三昧。	dies ist es, was man das 'Samādhi der Einen Form' nennt.

若於一切處行住坐臥，	Wenn ihr, wo immer ihr seid, beim Gehen, Stehen, Sitzen und Liegen
純¶一直心，	in jedem Augenblick den Zustand des 'Einen, direkten Geistes' erhalten könnt,
不動道場，	so seit ihr in der Lage, den unbeweglichen Ort der Übung,
真成淨土，	das wahre Reine Land, in jeder eurer Handlungen zu verwirklichen,
名一行三昧。	dies wird das 'Samādhi der Einen Handlung' genannt.

若¶人具二三昧，	Wer diese beiden Samādhis verwirklicht,
如地有種，	ist wie die Erde, die Samen enthält,
能含藏長養，	die über einen langen Zeitraum aufbewahrt und genährt werden,
成就其¶實，	uns schließlich die Frucht reifen läßt.
一相一行，	Mit der Einen Form und der Einen Handlung,
亦復如是。	ist es ganz genauso.
我今說法，	Was ich heute zu euch sage,
猶如時雨，¶	ist wie ein jahreszeitlicher Regen,
溥潤大地；	der die Erde bewässert,
汝等佛性，	Eure Buddha Natur 
譬諸種子，	läßt sich vergleichen mit den Samen,
遇茲霑洽，	die durch diese Feuchtigkeit 
悉¶得發生。	sämtlich zum Ausschlagen kommen.
承吾旨者，	Ihr alle, die ihr mir heute zuhört,
決獲菩提；	werdet alle die Erleuchtung erreichen;
依吾行者，	jeder von euch, der die Anstrengung macht,
定證¶妙果。」	wird sicherlich das Ergebnis bestätigen können."
**** 

先天元年，	Im 1. Jahr der Ära Xiantian
:zhu:
先天元年 [xian3tian1yuan2ning4]  712
:end:
告諸徒眾曰︰	sagte er zu der Versammlung seiner Schüler:
「吾忝受忍大師¶衣法，	"Die Robe und Lehre, die ich die Ehre hatte, von Meister Hongren zu erhalten,
今為汝等說法，	gebe ich heute durch meine Predigt an euch alle weiter,
不付其衣。	allerdings werde ich die Robe nicht mehr weiter geben.
蓋汝等信根¶淳熟，	Ich bin sicher, daß in euch die Lehre schon starke Wurzeln geschlagen hat,
決定不疑，	und daß ihr keinen Zweifel daran hegt,
堪任大事。	daß ihr schließlich die 'große Sache' verwirklichen könnt.
聽吾偈曰︰¶	Hört meinen Vers:

#+BEGIN_VERSE
『心地含諸種，	'Im Geistesgrund gibt es viele Samen,
　普雨悉皆生。¶	sie werden durch Regen zum keimen gebracht.
　頓悟華情已，	Wenn die Essenz der Blume in plötzlich erfasst wird,
　菩提果自成。』」¶	dann wird von selbst auch die Frucht der Erleuchtung erreicht.'"
#+END_VERSE

師說偈已，	Nachdem er diesen Vers rezitiert hatte, 
復曰︰	sagte er weiterhin:
「其法無二，	"Die Lehre ist nicht dual,
其心亦然，	ebensowenig ist es der Geist.
其道清¶淨，	Der Weg ist rein und klar,
亦無諸相。	es gibt keine Vielfalt der Formen.
汝等慎勿觀淨，	Mönche, seht euch vor und beschränkt euch nicht auf [die Übung] der bloßen reinen Beobachtung
及空其心，	und Entleerung des Geistes.
此心¶本淨，	Der Geist ist ursprünglich rein,
無可取捨，	es kann nichts erreicht oder verworfen werden,
各自努力，	strengt euch alle an
隨緣好去。」	und ihr werdet sicherlich gute Ergebnisse erlangen." 
**** 
師說法¶利生，	Vierzig Jahre sind vergangen, seid Huineng begann zu predigen und den Lebewesen zu nützen,
經四十載，
其年七月六日，	in diesem Jahr am 6. Tag des 7. Monats
命弟子。	erlaubte er seinen Schülern
往新¶州國恩寺。	zum Guoen Tempel nach Xinzhou zu gehen
建報恩塔，	und dort eine Pagode zu bauen, um [ihm] für diese Barmherzigkeit zu danken,
仍令倍工。	sie verdoppelten ihre Bemühungen bei diesen arbeiten.

又有蜀僧名¶方辯，	Ein Mönch aus Sichuan namens Fangbian 
來謁師云︰	kam um Huineng seine Aufwartung zu machen und sagte:
「善揑塑。」	"Ich bin gut darin, Abbildungen zu machen."

師正色曰︰	Der Meister setzte sich zurecht und sagte:
「試塑看。」	"Versuch mal, mich zu malen."

¶方辯不領旨，	Fangian verstand den Wunsch des Meisters nicht
乃塑師真，	und machte eine Figur des Meisters,
可高七寸，	von ungefähr 21 cm Höhe,
曲盡其妙。	die ausgesprochen fein gearbeitet war.

¶師觀之曰︰	Der Meister sah diese [Figur] an und sagte:
「汝善塑性，	"Die Figur ist zwar schön gearbeitet,
不善佛性。」	aber die Buddhanatur ist nicht gut getroffen."
酬以衣物，	Als Dank für diese Figur erhielt der Mönch eine Robe und weitere Gegenstände,
僧¶禮謝而去。	der Mönch bedankte sich und ging.

先天二年七月一日，	Am 1. Tag des 7. Monats im 2. Jahr der Ära Xiantian
謂門人曰︰	sagte er zu seinen Schülern:
「吾¶欲歸新州，	"Ich wünsche nun nach Xinzhou zurückzukehren,
汝速理舟檝。」	ich bitte um unverzügliche Bereitstellung eines Bootes."
時大眾哀慕，	Die Versammlung war in großer Trauer und bat ihn, 
乞師且¶住。	die Abfahrt noch etwas aufzuschieben.

師曰︰	Huineng sagte:
「諸佛出現，	"Selbst Buddha, als er auf der Welt war,
猶示涅槃，	ging schließlich ins Nirvana ein,
有來必去，	was gekommen ist, muß auch wieder gehen,
理亦¶常然，	dieses Prinzip gilt für alle.
吾此形骸，	Auch diese Form eines menschlichen Skeletts
歸必有所。」	muß wieder irgendwohin zurückkehren."

眾曰︰	Die Mönche sagten:
「師從此去，	"Meister, wenn Sie uns hier verlassen haben,
早¶晚却迴？」	wo werden sie Ihre Zeit verbringen?"


師曰︰	Huineng antwortete:
「葉落歸根，	"Blätter, die herunterfallen und zu ihren Wurzeln zurückkehren
來時無口。」	haben keinen Mund, [um zu sprechen,] wenn sie zurückkehren."

又問︰	Sie fragten weiter:
「師之¶法眼，	"Meister, wem übertragen Sie die
何人傳受？」	Überlieferung Ihrer Lehre?"

師曰︰	Huineng antwortete:
「有道者得，	"Menschen des Weges werden sie erlangen,
無心者通。」	und wer ohne Geist ist, wird sie verstehen."

又<pb:ZB6q0003_T_005-0236c>¶問︰	Sie fragten weiter:
「後莫有難否？」	"Wird es hier später Katastrophen geben?"

曰︰	Er antwortete:
「吾滅後五六年，	"Fünf oder sechs Jahre nach meinem Tod
當有一¶人來取吾首，	wird jemand kommen, der den Kopf von meinen Schultern nimmt.
聽吾記曰︰	Hört euch meine Prophezeiung an:
『頭上養親，	'Kümmert euch um die Eltern über euren Köpfen,
口裏須餐，	alle Münder brauchen Nahrung
¶遇滿之難，	Wenn ihr diese Katastrophe erlebt,
楊柳為官。』」	dann werden Yang und Liu die Offiziere sein [die sie untersuchen.]"
又云︰	Weiterhin sagte er:
「吾去七十年，	"70 Jahre nach meinem Tod,
有二¶菩薩。	wird es zwei Bodhisattvas geben,
從東方來，	die aus dem Osten kommen,
一在家一出家，	einer ist ein Laie, der andere ein Mönch.
同時興化，	Sie werden zu selben Zeit aktiv sein
建¶立吾宗，	und unsere Lehre aufbauen,
締緝伽藍，	indem sie viele Tempel bauen
昌隆法嗣。」	und viele Dharma Erben haben."

言訖，	Nachdem er so gesprochen hatte,
往新州國¶恩寺。	ging der Meister nach Xinzhou zum Gouen Tempel.
沐浴訖，	Dort nahm er ein Bad,
跏趺而化，	setzte sich in die Meditationshaltung und verließ diese Welt.
異香襲人，	Ein ungewöhnlicher Duft verbreitete sich
白虹屬地。	und ein weißer Regenbogen erschien auf der Erde.
¶即其年八月三日也。	Dies geschah am 3. Tag des 8. Monats in demselben Jahr.

時韶、新兩郡各修靈塔，	Zu jener Zeit waren in Shaozhou und Xinzhou schon Stupa gebaut worden,
¶道俗莫決所之。	aber weder Mönche noch Laien konnten entscheiden, wohin die körperlichen Überreste  gehen sollten.
兩郡刺史共焚香祝云︰	So hielten die beiden Gouverneure eine Zeremonie, verbrannten Weihrauch und sagten:
「香煙¶引處，	"Möge der Weihrauch den Ort weisen,
即師之欲歸焉。」	zu dem der Meister zurückkehren möchte."
時鑪香騰涌，	Der Rauch des Weihrauchgefäßes
直貫曹谿。	zog direkt in die Richtung von Caoxi.
¶以十一月十三日入塔，	Am 13. Tag des 11. Monats wurde der Leichnam in dem Stupa beigesetzt,
壽七十六。	sein Alter betrug 76 Jahre.


時韶州刺¶史韋據撰碑，	Der Gouverneur von Shaozhou, Wei Ju verfaßte die Grabinschrift.
門人憶念取首之記，	Die Schüler, die sich an die Prophezeiung von dem gestohlenen Kopf erinnerten,
遂先以鐵¶葉漆布固護師頸。	befestigten den Kopf mit eisernen Blättern und lackierten anschließend den Hals.
塔中有達磨所傳信衣	In den Stupe legten sie auch die Robe von Bodhidharma,
(西域屈眴¶，	(diese war aus einem Stoff aus den westlichen Ländern gefertigt,
布也。	
緝木綿華心織成。	und später mit chinesischen Brokatstickereien verziert worden.
後人以碧絹為裏)	Später war noch ein Innenfutter aus purpurner Seide ergänzt worden.)
中宗賜磨衲、	die prächtigen Edelsteine  
寶鉢，	und die Schale von Zhongzong,
方辯塑真、	die von Fangbian gefertigte Figur,
¶道具等，	sowie weitere zeremonielle Geräte.
主塔侍者尸之。	Der Wächter des Pagode wurde damit betraut [auf diese Dinge achtzugeben].

開元十年壬戍八月¶三日，	Am 3. Tag des 8. Monats im 10. Jahr der Ära Kaiyuan
夜半忽聞塔中如拽鐵索聲，	konnte um Mitternacht aus der Pagode ein Klirren wie von eisernen Ketten gehört werden.
僧眾驚起，	Die Mönche erhoben sich erschrocken 
¶見一孝子從塔中走出，	und konnten sehen, wie ein Mann in Trauerkleidung aus der Pagode rannte.
:zhu:
孝子 [xiao4zi3] def0101: n. ① dutiful son ② son in mourning M:ge/¹míng/²wèi
:end:
尋見師頸有傷，	Die Mönche untersuchten die Pagode und fanden, daß der Hals des Meisters beschädigt war.
具以¶賊事聞於州縣。	Sie meldeten den Vorfall den Behörden
縣令楊侃、	und der Magistrat Yang Kan, 
刺史柳無忝得牒，	sowie der Gouverneur Liu Wutian wurden beauftragt,
¶切加擒捉。	den Verdächtigen unverzüglich gefangen zu nehmen.

五日，	Fünf Tage später
於石角村捕得賊人，	wurde der Dieb im Dorf Shijiao verhaftet
送韶州¶鞫問。	und zum Gericht nach Shaozhou geschickt.
云︰	Es stellte sich heraus,
姓張，	daß sein Name Zhang 
名淨滿，	Jingman war
汝州梁縣人。	und er aus dem Bezirk Liang in Ruzhou stammte.
於洪州開¶元寺，	Er hatte im Kaiyuan Tempel in Hongzhou
受新羅僧金大悲錢二十千，	von dem koreanischen Mönch Kim Dabei 2000 Pfund erhalten,
令取六祖¶大師首，	damit er den Kopf des sechsten Patriarchen hole,
歸海東供養。」	und dieser ihn mit sich zurück ans östliche Meer nehmen konnte, um ihm dort zu huldigen.

柳守聞狀，	Nachdem er den Fall untersucht hatte, 
未即加刑，	aber die Strafe noch nicht festgestellt hatte,
乃¶躬至曹谿，	ging Gouverneur Liu zunächst nach Caoxi,
問師上足令韜曰︰	und fragte einen führenden Schülern des Meisters, Lingtao,
「如何處斷？」	wie dieser in diesem Fall entschieden würde.

韜曰︰	Lingtao sagte:
「¶若以國法論，	"Wenn man nach den Gesetzen des Landes ginge,
理須誅夷；	so müßte er streng bestraft werden.
但以佛教慈悲，	Wenn man aber die Barmherzigkeit der buddhistischen Lehre als Maßstab nimmt,
冤親¶平等，	so soll man Feinde und Verwandte in gleicher Weise behandeln,
況彼求欲供養，罪可恕矣！」	und wir sollten ihm vergeben, besonders, da sein Motiv die Verehrung unseres Meisters war."


柳守嘉歎曰︰	Der Gouverneur Liu seufzte und sagte:
「¶始知佛門廣大！」	"Nun verstehe ich erst wie breit das Tor der buddhistischen Lehre ist!"
遂赦之	Und damit wurde dem Dieb vergeben.
(爾後甚有名賢贊述及檀施珍異。	(Diese Entscheidung wurde später von vielen Weisen gelobt und es wurden auch Geschenke geschickt,
:zhu:
檀施 [tan3yi4] == 檀，梵語 dāna 之略譯，意即布施、捨施。
:end:
文繁不錄)	diese Briefe drucken wir hier nicht ab.)

上元¶元年，	Im 1. Jahr der Ära Shangyuan,
:zhu:
上元元年 [shang4yuan2yuan2ning4]  ==760
:end:
肅宗遣使。	schickte Kaiser Suzong einen Botschafter,
就請師衣鉢歸內供養。	der nach der Robe und Schale des Meisters fragte, um sie im Palast verehren zu können.

至永¶泰元年五月五日，	Später, am 5. Tag des 5. Monats im 1. Jahr der Ära Yongtai,
代宗夢六祖大師請衣鉢。	hatte Kaiser Daizong einen Traum, in dem ihn der sechste Patriarch nach Robe und Schale fragte.
¶七日，勅刺史楊瑊︰	Am 7. Tag schickte er folgenden Befehl an Gouverneur Yang Zhen:
云
「朕夢感能禪師請傳法¶袈裟却歸曹溪，	"Ich, der Kaiser, habe im Traum Chan Meister Huineng gesehen, der mich gebeten hat, die Robe der Übertragung des Dharma wieder nach Caoxi zurückzugeben,
今遣鎮國大將軍劉崇景。	daher beautrage ich hiermit den General der Nationalen Armee, Liu Chongjing,
頂<pb:ZB6q0003_T_005-0237a>¶戴而送。	sie in aller Ehre zu eskortieren.
朕謂之國寶，	Ich, der Kaiser wünsche, daß dieser Schatz von nationaler Bedeutung
卿可於本寺如法安置，	in diesem Tempel sicher aufbewahrt wird
¶專令僧眾親承宗旨者，	und beauftrage die Versammlung der Mönche, die seine Lehre erhalten haben,
嚴加守護，	diese gut zu schützen und zu bewahren,
勿令遺墜。」	damit kein Unheil geschehe."

¶後或為人偷竊，	Später wurde die Reliquie noch weitere viermal gestohlen, 
皆不遠而獲，	konnte aber jeweils wieder sichergestellt werden, bevor sie zu weit entfernt war.
如是者數四。

憲¶宗諡大鑒禪師，	Kaiser Xianzong verlieh [dem Meister] den posthumen Ehrentitel Chan Meister Dajian 
:zhu:
憲宗 [xian4zong1] 806-820
大鑒 [tai4jian4] == großer Spiegel
:end:
塔曰元和靈照。	und nannte die Pagode Yuanhe Lingzhao.

皇宋開寶¶初，	Zu Beginn der Kaibao Ära unserer Song Dynstie,
王師平南海。	kämpften die kaiserlichen Truppen am südlichen Meer, um die Gegend zu befrieden.
劉氏，	Der Clan der Familie Liu
殘兵作梗，	leistete noch Widerstand, aber seine Truppen wurden zertstreut
師之塔廟鞠¶為煨燼，	und die Pagode und Halle des Patriarchen wurde zerstört. 
而真身為守塔僧保護，	Die Mumie des Meisters wurde aber gerettet und von den Mönchen sichergestellt,
一無所損。	sie war in keiner Weise beschädigt.

尋¶有制興修，	Um die Zerstörungen zu reparieren, wurde ein neues Gesetz erlassen,
功未竟，	aber bevor die Arbeiten abgeschlossen waren,
會太宗即位，	bestieg Kaiser Taizong den Thron,
留心禪門，	er war der Chan Lehre sehr zugetan
頗¶增壯麗焉。	und trug viel zur Verschönerung des Tempels bei.
**** 
大師自唐先天二年癸丑入滅，	Seit dem Eingehen ins Nirvana des Meisters im 2. Jahre der Ära Xiantian der Tang Dynastie,
至¶今景德元年甲辰歲，	bis zu dem heutigen 1. Jahr der Ära Jingde der Song Dynstie,
凡二百九十二年矣。	sind insgesamt 292 Jahre vergangen.

得¶法者，	Diejenigen, die von ihm die Übertragung der Lehre erhielten,
除印宗等三十三人各化一方，	angefangen mit Yinzong, sind 33 an der Zahl und alle verbreiten die Lehre, jeder an einem anderen Ort.
標為正¶嗣，	Dies sind die offiziellen Erben, 
其外藏名匿迹者，	diejenigen, deren Namen versteckt und die keine Spuren hinterlassen haben,
不可勝紀，	können nicht gezählt werden.
今於諸家傳¶記中略錄十人，	Hier sind nun Biographien von 10 Meistern, die als in einer Seitenlinie stehend
謂之旁出。¶	angesehen werden können.

*** 西域堀多三藏

西域堀多三藏者，
天竺人也。
東遊韶陽，
見六¶祖，
於言下契悟。
後遊五臺，
至定襄縣歷村，
見¶一僧結庵而坐，
三藏問曰︰
「汝孤坐奚為？」


曰︰
「觀¶靜。」

三藏曰︰
「觀者何人？
靜者何物？」

其僧作禮，
¶問曰︰
「此理何如？」

三藏曰︰
「汝何不自觀自靜？」
彼¶僧茫然，
莫知其對。

三藏曰︰
「汝出誰門耶？」

曰︰
「神¶秀大師。」

三藏曰︰
「我西域異道最下根者，
不墮¶此見。
兀然空坐，
於道何益？」

其僧却問三藏︰
「¶所師何人？」

三藏曰︰
「我師六祖，
汝何不速往曹¶谿，
決其真要？」

其僧即捨庵往參六祖，
具陳前¶事。
六祖垂誨與三藏符合，
其僧信入。
三藏後¶不知
所終。¶
*** 韶州法海禪師
韶州法海禪師者，
曲江人也。
初見六祖，
問曰︰
「¶即心即佛，
願垂指喻。」


祖曰︰
「前念不生即心，
後¶念不滅即佛；
成一切相即心，
離一切相即佛。
¶吾若具說，
窮劫不盡，
聽吾偈曰︰
『¶
#+BEGIN_VERSE

　即心名慧，
　即佛乃定。
　定慧等持，
<pb:ZB6q0003_T_005-0237b>
¶
　意中清淨。
　悟此法門，
　由汝習性。¶
　用本無生，
　雙修是正。
#+END_VERSE¶

』」

法海信受，
以偈贊曰︰¶
#+BEGIN_VERSE

　即心元是佛，
　不悟而自屈。¶
　我知定慧因，
　雙修離諸物
#+END_VERSE¶

(壇經云。
門人法海者即禪師是也)。¶

*** 吉州志誠禪師

吉州志誠禪師者，
吉州太和人也。
少於荊南¶當陽山玉泉寺奉事神秀禪師。
後因兩宗盛¶化，
秀之徒眾往往譏南宗曰︰
「能大師不識一¶字，
有何所長？」

秀曰︰
「他得無師之智，
深悟上乘，
¶吾不如也。
且吾師五祖親付衣法，
豈徒然哉！
¶吾所恨不能遠去親近，
虛受國恩。
汝等諸人，
¶無滯於此，
可往曹谿質疑，
他日迴復，
還為吾¶說。」

師聞此語，
禮辭至韶陽，
隨眾參請，
不言來¶處。
時六祖告眾曰︰
「今有盜法之人潛在此會。」
¶師出禮拜，
具陳其事。


祖曰︰
「汝師若
為示眾？」

對¶曰︰
「常指誨大眾，
令住心觀靜，
長坐不臥。」

祖曰︰
「¶住心觀靜，
是病非禪。
長坐拘身，
於理何益？
聽¶吾偈曰︰
『¶
#+BEGIN_VERSE

　生來坐不臥，
　死去臥不坐。¶
　元是臭骨頭，
　何為立功過？
#+END_VERSE¶

』」

師。
曰︰
「未審大師以何法誨人？」

祖曰︰
「吾若言有¶法與人，
即為誑汝，
但且隨方解縛，
假名三昧，
¶聽吾偈曰︰
『¶
#+BEGIN_VERSE

　一切無心自性戒，
　一切無礙自性慧，¶
　不增不退自金剛，
　身去身來本三昧。
#+END_VERSE¶

』」

師聞偈悔謝，
即誓依歸，
乃呈一偈曰︰¶
#+BEGIN_VERSE

　五蘊幻身，
　幻何究竟？
　迴趣真如，¶
　法還不淨。
#+END_VERSE
<pb:ZB6q0003_T_005-0237c>
¶

祖然之，
尋迴玉泉。
¶
*** 匾檐山曉了禪師
匾檐山曉了禪師者，
傳記不載。
唯北宗門人¶忽雷澄撰塔碑，
盛行于世。
略曰︰
「師住匾檐山，
¶法號曉了，
六祖之嫡嗣也。
師得無心之心，
了¶無相之相。
無相者，
森羅眩目；
無心者，
分別熾¶然。
絕一言一響，
響莫可傳，
傳之行矣；
言莫可¶窮，
窮之非矣。
師自得無無之無，
不無於無也。
¶吾今以有有之有，
不有於有也。
不有之有，
去¶來非增；
不無之無，
涅槃非減。
嗚呼！
師住世兮¶
曹谿明，
師寂滅兮法舟傾，
師譚無說兮寰宇¶盈，
師示迷徒兮了義乘。
匾擔山色垂茲色，
空¶谷猶留曉了名。」¶
*** 河北智隍禪師
河北智隍禪師者，
始參五祖法席，
雖甞咨決，
¶而循乎漸行。
後往河北結庵長坐，
積二十餘¶載，
不見惰容。
及遇六祖門人策禪師遊歷于¶彼，
激以勤求法要，
師遂捨庵，
往參六祖。
祖愍¶其遠來，
便垂開抉，
師於言下豁然契悟，
前二¶十年所得心，
都無影響。
其夜，
河北檀越、
士庶，
¶忽聞空中有聲曰︰
「隍禪師今日得道也！」
後迴¶河北，
開化四眾。
¶
*** 
洪州法達禪師者，
洪州豐城人也。
七歲出家，
¶誦《法華經》。
進具之後，
來禮祖師，
頭不至地。
祖¶呵曰︰
「禮不投地，
何如不禮！
汝心中必有一物，
¶蘊習。
何事耶？」

師曰︰
「念《法華經》已及三千部。」

祖¶曰︰
「汝若念至萬部，
得其經意。
不以為勝，
則與¶吾偕行。
汝今負此事業，
都不知過，
聽吾偈曰︰
『¶
#+BEGIN_VERSE

　禮本折慢幢，
　頭奚不至地？¶
　有我罪即生，
　亡功福無比。
#+END_VERSE¶

』」

祖又曰︰
「汝名什麼？」

對曰︰
「名法達。」

祖
曰︰
「汝名
<pb:ZB6q0003_T_005-0238a>
¶法達，
何曾達法？」
復說偈曰︰¶
#+BEGIN_VERSE

　汝今名法達，
　勤誦未休歇。¶
　空誦但循聲，
　明心號菩薩。¶
　汝今有緣故，
　吾今為汝說。¶
　但信佛無言，
　蓮華從口發。
#+END_VERSE¶

師聞偈，
悔過曰︰
「而今而後，
當謙恭一切，
惟願¶和尚大慈，
略說經中義理。」

祖曰︰
「汝念此經，
以¶何為宗？」


師曰︰
「學人愚鈍，
從來但依文誦念，
豈¶知宗趣？」

祖曰︰
「汝試為吾念一遍，
吾當為汝解¶說。」

師即高聲念經，
至
〈方便品〉，
祖曰︰
「止！
此經元¶來以因緣出世為宗，
縱說多種譬喻，
亦無越¶於此。
何者因緣？
唯一大事。
一大事，
即佛知見¶也。
汝慎勿錯解經意，
見他道︰
『開示悟入自是¶佛之知見，
我輩無分。』
若作此解，
乃是謗經毀¶佛也。
彼既是佛，
已具知見，
何用更開？
汝今當¶信，
佛知見者，
只汝自心，
更無別體。
蓋為一切¶眾生自蔽光明，
貪愛塵境，
外緣內擾，
甘受驅¶馳，
便勞他從三昧起，
種種苦口，
勸令寢息，
莫¶向外求，
與佛無二，
故云開佛知見。
汝但勞勞¶執念，
謂為功課者，
何異犛牛愛尾
也？」

師曰︰
「若¶然者，
但得解義，
不勞誦經耶？」

祖曰︰
「經有何¶過，
豈障汝念？
只為迷悟在人，
損益由汝，
聽吾¶偈曰︰
『¶
#+BEGIN_VERSE

　心迷法華轉，
　心悟轉法華。¶
　誦久不明己，
　與義作讎家。¶
　無念念即正，
　有念念成邪。¶
　有無俱不計，
　長御白牛車。
#+END_VERSE¶

』」


師聞偈，
再啟曰︰
「經云。
諸大聲聞，
乃至菩薩，
皆¶盡思度量，
尚不能測於佛智。
今令凡夫但悟
<pb:ZB6q0003_T_005-0238b>
¶自心，
便名佛之知見，
自非上根，
未免疑謗。
又¶經說三車，
大牛之車與白牛車，
如何區別？
願¶和尚再垂宣說。」

祖曰︰
「經意分明，
汝自迷背。
諸¶三乘人不能測佛智者，
患在度量也。
饒伊盡¶思共推，
轉加懸遠。
佛本為凡夫說，
不為佛說，
¶此理若不肯信者，
從他退席。
殊不知坐却白¶牛車，
更於門外覓三車。
況經文明向汝道︰
『無¶二亦無三。』
汝何不省？
三車是假，
為昔時故；
一¶乘是實，
為今時故。
只教汝去假歸實，
歸實之，
¶後實亦無名。
應知所有珍財盡屬於汝，
由汝¶受用，
更不作父想，
亦不作子想，
亦無用想，
¶是名持《法華
經》。
從劫至劫，
手不釋卷，
從晝至¶夜，
無不念時也。」

師既蒙啟發，
踊躍歡喜，
以偈¶贊曰︰¶
#+BEGIN_VERSE

　經誦三千部，
　曹谿一句亡。¶
　未明出世旨，
　寧歇累生狂？¶
　羊鹿牛權設，
　初中後善揚。¶
　誰知火宅內，
　元是法中王。
#+END_VERSE¶

祖曰︰
「汝今後方可名為念經僧也。」
師從此領¶玄旨，
亦不輟誦持。
¶
*** 
壽州智通禪師者，
壽州安豐人也。
初看《楞伽¶經》約千餘遍，
而不會三身四智，
禮師求解其¶義。
祖曰︰
「三身者，
清淨法身，
汝之性也；
圓滿報¶身，
汝之智也；
千百億化身，
汝之行也。
若離本¶性別說三身，
即名有身無智；
若悟三身無有¶自性，
即名四智菩提。
聽吾偈曰︰
『¶
#+BEGIN_VERSE

　自性具三身，
　發明成四智。¶
　不離見聞緣，
　超然登佛地。¶
　吾今為汝說，
　諦信永無迷。
<pb:ZB6q0003_T_005-0238c>
¶
　莫學馳求者，
　終日說菩提。
#+END_VERSE¶

』」

師曰︰
「四智之義可得聞乎？」

祖曰︰
「既會三身，
便¶明四智，
何更問邪？
若離三身，
別譚四智，
此名¶有智無身也。
即此有智，
還成無智。」
復說偈曰︰¶
#+BEGIN_VERSE

　大圓鏡智性清淨，
　平等性智心無病，¶
　妙觀察
智見非功，
　成所作智同圓鏡。¶
　五八六七果因轉，
　但用名者無實性。¶

　若於轉處不留情，
　繁興永處那伽定
#+END_VERSE¶

(轉識為智者。
教中云。
轉前五識為成所作智。
轉第六識為妙觀察智。
轉第七識為平等性智。
轉第八識為大

¶圓鏡智。
雖六七因中轉。
五八果上轉。
但轉其名而不轉其體也)。¶

師禮謝，
以偈贊曰︰¶
#+BEGIN_VERSE

　三身元我體，
　四智本心明。¶
　身智融無礙，
　應物任隨形。¶
　起修皆妄動，
　守住匪真精。¶
　妙言因師曉，
　終亡污染名。
#+END_VERSE¶
*** 
江西志徹禪師者，
江西人也，
姓張氏，
名行昌。
¶少任俠，
自南北分化，
二宗主雖亡彼我，
而徒¶侶競起愛憎。
時北宗門人自立秀師為第六¶祖，
而忌能大師傳衣，
為天下所聞。
然祖是菩¶薩，
預知其事，
即置金十兩於方丈。
時行昌受¶北宗門人之囑，
懷刃入祖室，
將欲加害。
祖舒¶頸而就，
行昌揮刃者三，
都無所損。

祖曰︰
「正劍¶不邪，
邪劍不正，
只負汝金，
不負汝命。」

行昌驚¶仆，
久而方甦，
求哀悔過，
即願出家。
祖遂與金¶云︰
「汝且去，
恐徒眾翻害於汝，
汝可他日易形¶而來，
吾當攝受。」


行昌稟旨宵遁，
終投
僧出家，
¶具戒精進。
一日，
憶祖之言，
遠來禮覲。
祖曰︰
「吾¶久念於汝，
汝來何晚？」

曰︰
「昨蒙和尚捨罪，
今雖¶出家苦行，
終難報於深恩，
其唯傳法度生乎？
<pb:ZB6q0003_T_005-0239a>
¶弟子嘗覽《涅槃經》，
未曉常、
無常義，
乞和尚慈¶悲，
略為宣說。」

祖曰︰
「無常者，
即佛性也；
有常¶者，
即善惡一切諸法，
分別心也。」

曰︰
「和尚所說，
¶大違經文也。」

祖曰︰
「吾傳佛心印，
安敢違於佛¶經？」

曰︰
「經說佛性是常，
和尚却言無常；
善惡諸¶法乃至菩提心皆是無常，
和尚却言是常，
此¶即相違，
令學人轉加疑惑。」


祖曰︰
「《涅槃經》，
吾昔¶者聽尼無盡藏讀誦一遍，
便為講說，
無一字¶一義不合經文，
乃至為汝，
終無二說。」

曰︰
「學人¶識量淺昧，
願和尚委曲開示。」

曰︰
「汝知否？
佛¶性若常，
更說什麼善惡諸法，
乃至窮劫無有¶一人發菩提心者，
故吾說無常，
正是佛說真¶常之道也。
又一切諸法若無常者，
即物物皆¶有自性，
容受生死，
而真常性有不遍之處，
故¶吾說常者，
正是佛說真無常義也。
佛比
為凡¶夫外道執於邪常，
諸二乘人於常計無常共¶成八倒，
故。於涅槃了義教中，
破彼偏見，
而顯¶說真常、
真我、
真淨。
汝今依言背義，
以斷滅無¶常及確定死常，
而錯解佛之圓妙最後微言，
¶縱覽千遍，
有何所益！」

行昌忽如醉醒，
乃說偈¶曰︰¶
#+BEGIN_VERSE

　因守無常心，
　佛演有常性。¶
　不知方便者，
　猶春池執礫。¶
　我今不施功，
　佛性而見前。¶
　非師相授與，
　我亦無所得。
#+END_VERSE
¶

祖曰︰
「汝今徹也，
宜名志徹。」
師禮謝而去。¶

信州智常禪師者，
本州貴谿人也。
髫年出家，
¶志求見性。
一日，
參六祖，
祖問︰
「汝從何來？
欲求¶何事？」

師曰︰
「學人近往洪州建昌縣白峯山。
禮
<pb:ZB6q0003_T_005-0239b>
¶大通和尚，
蒙示見性成佛之義，
未決狐疑。
至¶吉州，
遇人指迷，
令投謁和尚，
伏願垂慈攝受！」

¶祖曰︰
「彼有何言句？
汝試舉似於吾，
與汝證明。」

¶師曰︰
「初到彼三月，
未蒙開示，
以為法切故，
於¶中夜獨入方丈禮拜哀請，
大通乃曰︰
『汝見虛¶空否？』
對曰︰
『見。』
彼曰︰
『汝見虛空有相貌否？』
對¶曰︰
『虛空無形，
有何相
貌？』
彼曰︰
『汝之本性猶如¶虛空，
返觀自性，
了無一物可見，
是名正見；
無¶一物可知，
是名真知；
無有青黃、
長短，
但見本¶源清淨，
覺體圓明，
即名見性成佛，
亦名極樂¶世界，
亦名如來知見。』
學人雖聞此說，
猶未決¶了，
乞和尚誨示，
令無凝滯。」


祖曰︰
「彼師所說，
¶猶存見知故，
令汝未了，
吾今示汝一偈曰︰
『¶
#+BEGIN_VERSE

　不見一法存無見，
　大似浮雲遮日面。¶
　不知一法守空知，
　還如太虛生閃電。¶
　此之知見瞥然興，
　錯認何曾解方便？¶
　汝當一念自知非，
　自己靈光常顯見。
#+END_VERSE¶

』」

師聞偈已，
心意豁然，
乃述一偈曰︰¶
#+BEGIN_VERSE

　無端起知解，
　著相求菩提。¶
　情存一念悟，
　寧越昔時迷？¶
　自性覺源體，
　隨照枉遷流。¶
　不入祖師室，
　茫然趣兩頭。
#+END_VERSE¶

廣州志道禪師者，
南海人也。
初參六祖曰︰
「學¶人自出家，
覽《涅槃經》僅十餘載，
未明大意，
¶願和尚垂誨。」

祖曰︰
「汝何處未了？」

對曰︰
「諸行無¶常，
是生滅法。
生滅滅已，
寂滅為樂。
於此疑¶惑。」


祖曰︰
「汝作麼生疑？」

對曰︰
「一切眾生皆有二¶身，
謂
色身、
法身也。
色身無常，
有生有滅；
法身¶有常，
無知無覺。
經云
『生滅滅已，
寂滅為樂』
者，
<pb:ZB6q0003_T_005-0239c>
¶未審是何身寂滅？
何身受樂？
若色身者，
色身¶滅時，
四大分散全是苦，
苦不可言樂；
若法身¶寂滅，
即同草木瓦石，
誰當受樂？
又法性是生¶滅之體，
五蘊是生滅之用，
一體五用，
生滅是¶常，
生則從體起用，
滅則攝用歸體。
若聽更生，
¶即有情之類不斷不滅；
若不聽更生，
即永歸¶寂滅，
同於無情之物。
如是，
則一切諸法。
被涅¶槃之所禁伏，
尚不得生，
何樂之有？」

祖曰︰
「汝是¶釋子，
何習外道斷常邪見。
而議最上乘法？
據¶汝所解，
即色身外別有法身，
離生滅求於寂¶滅。
又推涅槃常樂，
言有身受者，
斯乃執吝生¶死，
耽著世樂。
汝今當知，
佛為一切迷人認五¶蘊和合為自體相，
分別一切法為外塵相，
好¶生惡死，
念念遷流，
不知夢幻虛假，
枉受輪迴，
¶以常樂涅槃翻為苦相，
終日馳求，
佛愍此故，
乃¶示涅槃真樂。
剎那無有生相，
剎那無有滅相
，¶更無生滅可滅，
是則寂滅見前。
當見前之時¶，
亦無見前之量，
乃謂常樂。
此樂無有受者，
亦無¶不受者，
豈有一體五用之名？
何況更言涅槃禁¶伏諸法，
令永不生？
斯乃謗佛毀法。


「聽吾偈曰︰
『¶
#+BEGIN_VERSE

　無上大涅槃，
　圓明常寂照。¶
　凡愚謂之死，
　外道執為斷。¶
　諸求二乘人，
　目以無為作。¶
　盡屬情所計，
　六十二見本。¶
　妄立虛假名，
　何為真實義？¶
　唯有過量人，
　通達無取捨。¶
　以知五蘊法，
　及以蘊中我，¶
　外現眾色象，
　一一音聲相，¶
　平等如夢幻，
　不起凡聖見，
<pb:ZB6q0003_T_005-0240a>
¶
　不作涅槃解，
　二邊三際斷。¶
　常應諸根用，
　而不起用想；¶
　分別一切法，
　不起分別想。¶
　劫火燒海底，
　風鼓山相擊。¶
　真常寂滅樂，
　涅槃相如是。¶
　吾今彊言說，
　令汝捨邪見。¶
　汝勿隨言解，
　許汝知少分。
#+END_VERSE¶

』」
師聞偈踊躍，
作禮而退。¶
*** 廣州法性寺印宗和尚	Ehrenwerter Yinzong vom Faxing Tempel in Guangzhou
廣州法性寺印宗和尚者，	Der Ehrenwerte Yinzong vom Faxing Tempel in Guangzhou
吳郡人也，	stammte aus Wujun,
姓印氏。	sein Familienname war Yin.
¶從師出家，	Seitdem er Mönch geworden war,
精《涅槃》大部。	studierte er vor allem das große /Nirvana Sutra/.
唐咸亨元年抵京師，	Im 1. Jahre der Ära Xianpeng der Tang Dynastie, ging er in die Hauptstadt
¶勅居大敬愛寺，	und lebte dort im Dajingai Tempel
固辭，	Er weigerte sich, [am kaiserlichen Hof zu erscheinen]
往蘄春謁忍大師。	und ging stattdessen zu Großmeister Hongren, um mit ihm zu üben.

後於¶廣州法性寺講《涅槃經》，	Später hörte er eine Predigt des sechsten Patriarchen Huineng im Faxing Tempel in Guangzhou
遇六祖能大師，
始悟¶玄理，	und verstand zum ersten Mal das geheimnisvolle Prinzip,
以能為傳法師。	daher betrachtete er Huineng als seinen Dharma Meister.

又採自梁至唐諸方達¶者之言，	Er sammelte Predigten von Weisen aller Schulrichtungen aus der Zeit von der Liang bis zur Tang Dynastie,
著《心要集》，	die unter dem Titel /Sammlung der Essenz des Geistes/
盛行于世。	in der Welt zirkulierte.

先天二年二月¶二十一日，	Am 21. Tag des 2. Jahres der Ära Xiantian
:zhu:
先天二年二月二十一 [xian3tian1er4ning4er4yue4er4shi2yi1] == 713
:end:
終于會稽山妙喜寺，	start er im Miaoxi Tempel am Guiji Berg,
壽八十有七。	er war 87 Jahre alt geworden.
¶會稽王師乾立塔銘焉。	Wang Shigan errichtete für ihn eine Pagode und Stele am Guiji Berg.
¶
*** 吉州青原山行思禪師
吉州青原山行思禪師，
本州安城人也，
姓劉¶氏。
幼歲出家，
每群居論道，
師唯默然。
後聞曹¶谿法席，
乃往參禮，
問曰︰
「當何所務即不落階¶級？」

祖曰︰
「汝曾作什麼？」

師曰︰
「聖諦亦不為。」

祖¶曰︰
「落何階級？」

曰︰
「聖諦尚不為，
何階級之有？」

祖¶深器之，
會下學徒雖眾，
師居首焉。
亦猶二祖¶不言，
少林謂之得髓矣。

一日，
祖謂師曰︰
「從上¶衣法雙行，
師資遞授，
衣以表信，
法乃印心，
吾¶今得人，
何患不信？
吾受衣以來，
遭此多難，
況¶乎後代，
爭競必多，
衣即留鎮山門，
汝當分化¶一方，
無令斷絕。」
師既得法，
住吉州青原山靜¶居寺。

六祖將示滅，
有沙彌希遷
(即南嶽石頭和尚也)
問曰︰
「¶和尚百年後，
希遷未審當依附何人？」


祖曰︰
「尋<pb:ZB6q0003_T_005-0240b>¶思去。」

及祖順世，
遷每於靜處端坐，
寂若忘生。
¶第一坐
問曰︰
「汝師已逝，
空坐奚為？」

遷曰︰
「我稟¶遺誡，
故尋思爾。」

第一坐曰︰
「汝有師兄行思和¶尚，
今住吉州，
汝因緣在彼，
師言甚直，
汝自迷¶耳。」
遷聞語，
便禮辭祖龕，
直詣靜居。

師問曰︰
「子¶何方而來？」

遷曰︰
「曹谿。」

師曰︰
「將得什麼來？」

曰︰
「¶未到曹谿亦不失。」

師曰︰
「恁麼用去曹谿作什¶麼？」

曰︰
「若不到曹谿，
爭知不失？」

遷又問曰︰
「曹谿¶大師還識和尚否？」

師曰︰
「汝今識吾否？」


曰︰
「識¶又爭能識得？」

師曰︰
「眾角雖多，
一麟足矣！」

遷又¶問︰
「和尚出嶺多少時？」

師曰︰
「我却不知，
汝早¶晚離曹谿？」

曰︰
「希遷不從曹谿來。」

師曰︰
「我亦知¶汝去處也。」

曰︰
「和尚幸是大人，
莫造次。」

他日，
¶師復問遷︰
「汝什麼處來？」

曰︰
「曹谿。」

師乃舉拂¶子曰︰
「曹谿還有這箇麼？」

曰︰
「非但曹谿，
西天亦¶無。」


師曰︰
「子莫曾到西天否？」

曰︰
「若到，
即有也。」

師¶曰︰
「未在，
更道。」

曰︰
「和尚也須道取一半，
莫全靠¶學人。」

師曰︰
「不辭向汝道，
恐已後無人承當。」

師¶令希遷持書與南嶽讓和尚，
曰︰
「汝達書了，
速¶迴，
吾有箇鈯斧子。
與汝住山。」

遷至彼，
未呈書，
¶便問︰
「不慕諸聖，
不重己靈時如何？」

讓曰︰
「子問¶太高生，
何不向下問？」

遷曰︰
「寧可永劫沈淪,¶不慕諸聖解脫。」
讓便休。

遷迴至靜居，
師問¶曰︰
「子去未久，
送書達否？」

遷曰︰
「信亦不通，
書亦¶不達。」

師曰︰
「作麼生？」

遷舉前話了，
却云︰
「發時¶蒙和尚許鈯斧子，
便請取。」
師垂一足，
遷禮¶拜，
尋辭往南嶽。


(玄沙云︰
「大小石頭和尚。
被讓師推倒，
至今起不得。)」

荷澤神¶會來參，
師問曰︰
「什麼處來？」

會曰︰
「曹谿。」

師曰︰
「¶曹谿意旨如何？」
會振身而已。

師曰︰
「猶滯瓦礫
<pb:ZB6q0003_T_005-0240c>
¶在。」

曰︰
「和尚此間莫有真金與人否？」

師曰︰
「設有，
¶與汝向什麼處著？
(」

玄沙云︰
「果然。」

雲居錫云︰
「只如玄沙道果然，
是真金？
是瓦礫？)」

僧¶
問︰
「如何是佛法大意？」

師曰︰
「廬陵米作麼價？」

師¶既付法石頭。
唐開元二十八年庚辰十二月¶十三日，
陞堂告眾，
跏趺而逝。
僖宗諡弘濟禪¶師歸真之塔。¶
*** TODO 南嶽懷讓禪師	Chan Meister Nanyue Huairang
南嶽懷讓禪師者，	Meister Huairang vom Nanyue Berg,
姓杜氏，	trug den Familiennamen Du
金州人也。	und stammte aus Jinzhou. 
年十五，	Als er 15 Jahre alt war
¶往荊州玉泉寺，	ging er nach Jingzhou zum Yuquan Tempel
依弘景律師出家。	und wurde dort von dem Vinaya Meister Hongjing als Novize angenommen.
受具之後，	Später, nachdem er die vollständigen Gebote erhalten hatte,
¶習《毘尼藏》。	machte er sich daran, den Kanon der Ordensregeln zu studieren.
一日，自歎曰︰	Eines Tages seufzte er und sagte zu sich selbst:
「夫出家者，	"Das Leben eines Mönchs
為無為法¶。」	besteht darin, das Nichts zur Lehre zu machen."
時同學坦然，	Zu jener Zeit war da ein Mitschüler namens Tanran,
知師志高邁，	der wußte, daß Huairang hohe Ambitionen hatte.
勸師謁嵩山安和¶尚。	Er riet ihm, zum Berg Song zu gehen und bei dem Ehrenwerten [Hui]an zu lernen.
安啟發之，	Huian sah ihn und erkannte sofort [seine Fähigkeiten],
乃直詣曹谿參六祖。	daher schickte er ihn direkt nach Caoxi zum sechsten Patriarchen.

祖問︰	Der Patriarch fragte:
「什麼¶處來？」	"Wo kommst du her?"

曰︰	Huairang antwortete:
「嵩山來。」	"Ich komme vom Berg Song."

祖曰︰	Der Patriarch fragte weiter:
「什麼物恁麼來？」	"Was für eine Sache ist auf welche Weise gekommen?"

曰︰	Huairang antwortete:
「說似¶一物即不中。」	"Wenn ich es sagen will, dann verfehle ich es."

祖曰︰	Der Patriarch fragte:
「還可修證否？」	"Kann es denn durch Übung nachgewiesen werden?"

曰︰	Huairang sagte:
「修證即不¶無，	"Wenn ich [bewußt] übe, so ist es nicht da,
污染即不得。」	es wird beschmutzt und kann nicht erreicht werden."


祖曰︰	Der Patriarch sagte:
「只此不污染，	"Genau dieses 'nicht beschmutzt werden' 
諸佛之所¶護念，	ist das, worum es allen Buddhas ging.
汝既如是，	Dir geht es auch so
吾亦如是。	und auch bei mir ist es nicht anders.
西天般若多羅讖。	Prajñatāra im Westen
¶汝足下出一馬駒，	sagte voraus, daß unter deinen Füßen ein Fohlen hervorkommen werde,
蹋殺天下人，	das auf die Erde trampeln und die Menschen verändern würde.
並在汝心，	Noch ist es aber in deinem Geist
不¶須速說。」	und du darfst es nicht zu früh herauslassen."

師豁然契會，	Huairang erlangte plötzlich Übereinstimmung
執侍左右一十五載。	und diente [dem sechsten Patriarchen] für 15 Jahre als Aufwärter.
**** 
唐¶先天二年，	Im 2. Jahr der Ära Xiantian
##==713
始往衡嶽，	ging er zum ersten Mal zum Berg Heng,
居般若寺。	dort lebte er im Banruo Tempel.

開元中，	Während der Ära Kaiyuan
有沙¶門道一	kam ein Novize namens Daoyi,
(即馬祖大師也)	(das war der spätere Großmeister Mazu)
住傳法院，	der lebte in der Zhuanfa Halle
常日坐禪，	und praktizierte das Sitzen in Meditation jeden Tag.
師知是法¶器，	Huairang erkannte seine Begabung als ein Werkzeug des Dharma
往問曰︰	und fragte:
「大德坐禪圖什麼？」	"Was bezweckst du denn mit dem Sitzen in Meditation?"

一曰︰	Daoyi antwortete:
「圖作佛。」	"Ich möchte ein Buddha werden."
¶師乃取一塼，	Da nahm Huairang einen Ziegel
於彼庵前石上磨。	und rieb ihn gegen einen Stein am Eingang des Tempels.

一曰︰	Daoyi fragte:
「師作¶什麼？」	"Meister, was machen Sie denn da?"

師曰︰	Huairang antwortete:
「磨作鏡。」	"Ich möchte einen Spiegel machen."

一曰︰	Daoyi fragte:
「磨塼豈得成鏡耶？」¶	"Wie kann man denn durch Reiben aus einem Ziegel einen Spiegel machen?"

「坐禪豈得成佛耶？」	"Wie kann man denn durch Sitzen ein Buddha werden?"

一曰︰	Daoyi fragte:
「如何即是？」	"Was ist also zu tun?"

師曰︰	Huairang sagte:
「如¶人駕車不行，	"Es ist wie wenn man auf einem Ochsenkarren sitzt, der sich nicht bewegt.
打車即是？	soll man da denn Wagen schlagen?
打牛即是？」	oder soll man den Ochsen schlagen?"
一無對。	[Daoyi] antwortete nicht.

¶師又曰︰	Huairang sagte weiterhin:
「汝學坐禪？	"Du willst also üben, in Meditation zu sitzen,
為學坐佛？	willst du üben, wie ein Buddha zu sitzen?
若學坐禪，	Wenn du in Meditation sitzen willst,
禪¶非坐臥；	so wisse, daß die Meditation nicht im sitzen oder liegen ist,
若學坐佛，	wenn du üben willst, zu sitzen wie ein Buddha,
佛非定相。	so wisse, daß Buddha keine bestimmte Form hat.
於無住法，	Alle Dharmas sind unbeständig,
不應¶取捨。	du sollst nicht die einen behalten und die anderen verwerfen.
汝若坐佛，	Wenn du wie ein Buddha sitzt,
即是殺佛；	so bedeutet das Buddha zu töten.
若執坐相，	Wenn du dich an die Form des Sitzens klammerst,
非達其¶理。」	so wirst du das Prinzip nicht erreichen."

一聞示誨，	Als Daoyi dies hörte, 
如飲醍醐，	war ihm als hätte er Sahne getrunken,
禮拜問曰︰	er verbeugte sich und sagte:
「如何用心，	"Wie kann ich es erreichen,
¶即合無相三昧？」	daß ich in Einklang mit dem formlosen Samadhi bin?"

師曰︰	Huairang sagte:
「汝學心地法門，	"Wenn Du die Lehre vom Geistesgrund lernst,
如下種<pb:ZB6q0003_T_005-0241a>¶子；	so ist das wie das Säen eines Samens,
我說法要，	und meine Predigten
譬彼天澤。	sind wie die natürliche Befeuchtung.
汝緣合故，	Weil deine karmische Bestimmung auf diese Weise zusammengekommen ist,
當見其道。」	wirst du sicherlich den Weg erlangen."

¶又問曰︰	Daoyi fragte weiter:
「道非色相，	"Der Weg hat kein Gestalt und Form,
云何能見？」	wie kann man ihn da sehen?"

師曰︰	Huairang sagte:
「心地法眼¶能見乎道，	"Das Dharma-Auge des Geistesgrundes kann den Weg sehen
無相三昧亦復然矣。」	und mit dem formlosen Samadhi ist es ebenso."

一曰︰	Daoyi fragte:
「有成壞¶否？」	"Gibt es Vollendung und Zerstörung?"

師曰︰	Huairang sagte:
「若以成壞聚散而見道者，	"Wenn du den Weg [mit den Begriffen] Vollendung, Zerstörung, Sammeln oder Zerstreuen ansiehst,
非見道也。	dann siehst du nicht den Weg.
¶聽吾偈曰︰¶	Höre meinen Vers:
#+BEGIN_VERSE
『心地含諸種，	Der Geistesgrund enthält viele Samen,
　遇澤悉皆萌。¶	wenn sie befeuchtet werden, so keimen sie.
　三昧華無相，	Die Blume des Samadhi ist ohne Form,
　何壞復何成？』」¶	wie könnte sie zerstört oder zusammengefügt werden?"
#+END_VERSE

一蒙開悟，	Daoyi erlangte auf diese Weise die Erleuchtung
心意超然，	und war vollkommen überwältigt von der Erfahrung.
侍奉十秋，	Er diente [Huairang] zehn Jahre lang als Aufwärter
日益玄奧。	und vertiefte sein Verständnis für die geheimnisvollen Tiefen der Lehre täglich.

**** 
師¶入室弟子總有六人，	Meister Huairang hatte sechs Schüler, denen das Eintreten in den Raum des Meisters gestattet war,
師各印可云︰	er gab jedem von ihnen die Übertragung des Siegels der Lehre und sagte:
「汝等六人¶同證吾身，	"Ihr sechs seid Zeugnis meines Körpers
各契一路。	und jeder hat ihn auf seine Weise verstanden:
一人得吾眉，	Zhanghao hat meine Augenbrauen,
善威儀（	und hat eine beeindruckende, Autorität heischende Erscheinung;
(常浩）)；
一¶人得吾眼，	Zhida hat had meine Augen,
善顧盻（	er kann damit stechende Blicke werfen;
(智達）)；
一人得吾耳，	Tanran hat meine Ohren,
善聽理（	er ist besonders gut darin, Leuten zuzuhören:
(坦然）)；
一¶人得吾鼻，	Shenzhao hat meine Nase,
善知氣（	und kann riechen, was in der Luft liegt;
(神照）)；
一人得吾舌，	Yanjun hat meine Zunge
善譚說（	und kann wunderbar sprechen;
(嚴峻）)；
一¶人得吾心，	Daoyi hat meinen Geist,
善古今（	er ist gut darin, Vergangenes und Kommendes [zu wissen].
(道一）)。」

又曰︰	Weiterhin sagte er:
「一切法皆從心生，	"Alle Dinge, die existieren sind sämtlich aus dem Geist geboren,
¶心無所生，	der Geist aber ist selbst nicht aus irgendetwas hervorgegangen.
法無能住。	Dharmas sind nicht in der Lage, stetig zu verweilen.
若達心地，	Wenn ihr den Geistesgrund erreicht,
所作無礙。	dann trefft ihr auf keine Hindernisse.
非¶遇上根，	Wenn ihr nicht auf überlegene Menschen trefft,
宜慎辭哉！」	seid vorsichtig darin, was ihr sagt und wie ihr es sagt!"
**** 
有一大德。	Einmal kam ein erfahrener Mönch und 
問︰	fragte:
「如鏡鑄像，	"Wenn ein Bild in einem Spiegel abgebildet ist,
像¶成後，	nachdem das Bild entstanden ist,
鏡明向什麼處去？」	wohin geht die Leuchtkraft des Spiegels?"

師曰︰	Huairang antwortete:
「如大德為童子¶時相貌何在？」	"Als Sie, Ehrwürden, ein Kind waren, wo war da ihr jetztiges Gesicht?"
(法眼別云︰	Fayan sagte dazu:
「阿那箇是大德鑄成底像？)」	"Wieso macht er denn ein so unzutreffendes Bild von dem Ehrwürden?"

曰︰	Der Mönch fragte weiter:
「只如像成後，	"Warum betrachten Sie nicht die Situation nachdem das Bild geformt ist?"
為¶什麼不鑑照？」

師曰︰	Huairang sagte:
「雖然不鑑照，	"Auch wenn ich dies nicht betrachte,
謾他一點不¶得。」	so war meine Absicht doch nicht, in irgendeiner Weise unhöflich zu sein."
**** 
後馬大師闡化於江西，	Später begann Mazu in Jiangxi zu lehren.
師問眾曰︰	Huairang fragte die Mitglieder seiner Versammlung:
「道一為¶眾說法否？」	"Predigt Daoyi denn auch seiner Versammlung?"

眾曰︰	Die Mönche antworteten:
「已為眾說法。」	"Ja, er predigt auch."

師曰︰	Huairang sagte:
「總未見人¶持箇消息來。」	"Ich habe noch keinen gesehen, der mir irgendetwas davon erzählt hätte."
眾無對。	Niemand antwortete.

因遣一僧去，	Daher beauftragte er nun einen Mönch und sagte ihm:
云︰	
「待伊上¶堂時，	"Geh zu ihm und warte, bis er die Predigt beginnt,
但問作麼生，	dann frage ihn, wie es ihm geht.
伊道底言語，	Höre gut zu was er sagt
記將來。」	und komme wieder her, um mir davon zu berichten."

僧去，	Der Mönch ging
¶一如師旨，	und tat  wie ihm aufgetragen war.
迴謂師曰︰	Er kam zurück und berichtete:
「馬師云︰	"Meister Ma sagte:
『自從胡亂後，	'Seit dem Beginn des Barbarenaufstands bis heute,
三¶十年不曾闕鹽醬喫。』」	sind 30 Jahre vergangen und mir hat es nie an Salz oder Sauce gefehlt.'"
師然之。	Meister Huairang akzeptierte diese Antwort.

天寶三年八月¶十一日，	Am 11. Tag des 8. Monats des 3. Jahres der Ära Tianbao
== 744
圓寂於衡嶽，	ging er auf dem Berg Heng in die vollkommene Ruhe ein.
勅諡大慧禪師最勝輪¶之塔。¶	Der Kaiser verlieh ihm den posthumen Titel Dahui, und seine Grabstätte wurde Zuishenglun genannt.
*** 溫州永嘉玄覺禪師
溫州永嘉玄覺禪師者，
永嘉人也，
姓戴氏。
丱¶歲出家，
遍探三藏，
精天台止觀圓妙法門，
於¶四威儀中，
常冥禪觀。
後因左谿朗禪師激勵，
<pb:ZB6q0003_T_005-0241b>
¶與東陽策禪師同詣曹谿。

初到，
振錫携瓶，
繞¶祖三匝，
祖曰︰
「夫沙門者，
具三千威儀，
八萬細¶行，
大德自何方而來，
生大我慢？」

師曰︰
「生死事¶大，
無常迅速。」


祖曰︰
「何不體取無生，
了無速乎？」

¶曰︰
「體即無生，
了本無速。」

祖曰︰
「如是！
如是！」

于時，
¶大眾無不愕然。
師方
具威儀參禮，
須臾告辭，
¶祖曰︰
「返太速乎？」

師曰︰
「本自非動，
豈有速耶？」

祖¶曰︰
「誰知非動？」

曰︰
「仁者自生分別。」

祖曰︰
「汝甚得¶無生之意。」

曰︰
「無生豈有意耶？」

祖曰︰
「無意誰當¶分別？」

曰︰
「分別亦非意。」


祖歎曰︰
「善哉！
善哉！
少留¶一宿。」

時謂一宿覺矣，
策公乃留師。
翌日下山¶迴溫江，
學者輻湊，
號真覺大師。
著《證道歌》¶一首，
及禪宗悟修圓旨，
自淺之深。
慶州刺史¶魏靖。
緝而序之成十篇，
目為《永嘉集》並，
盛行¶于世。¶

慕道志儀第一¶

夫欲修道，
先須立志，
及事師儀則，
彰乎軌訓，¶

故標第一，
明慕道儀式。¶

戒憍奢意第二¶

初雖立志修道，
善識軌儀，
若三業憍奢，
妄心¶擾動，
何能得定？
故次第二，
明戒憍奢意也。¶

淨修三業第三¶

前戒憍奢，
略標綱要。
今子細檢責，
令過不生，
¶故次第三，
明淨修三業，
戒乎身口意也。¶

奢摩他頌第四¶

已檢責身口，
令麁過不生。
次須入門修道，
漸¶次不出定慧、
五種起心、
六種料簡，
故次第四，¶
明奢摩他頌也。¶


毘婆舍那頌第五
<pb:ZB6q0003_T_005-0241c>
¶

非戒不禪，
非禪不慧。
上既修定，
定久慧明，
故¶次第五，
明毘婆舍那頌也。¶

優畢叉頌第六¶

偏修於定，
定久則沈；
偏學於慧，
慧多心動。
故¶次第六，
明優畢叉頌，
等於定慧，
令不沈動，
使¶定慧均等，
捨於二邊。¶

三乘漸次第七¶

定慧既均，
則寂而常照。
三觀一心，
何疑不遣？
¶何照不圓？
自解雖明，
悲他未悟，
悟有深淺，
故¶次第七，
明三乘漸次也。¶

事理不二第八¶

三乘悟理，
理無不窮。
窮理在事，
了事即理，
故¶次第八，
明事理不二，
即事而真，
用祛倒見也。¶


勸友人書第九¶

事理既融，
內心自瑩，
復悲遠學，
虛擲寸陰，
故¶次第九，
明勸友人書也。¶

發願文第十¶

勸友人雖是悲他，
專心。
在一，
情猶未普，
故次¶第十，
明發願文，
誓度一切。¶

復次，
觀心十門︰
初則言其法爾，
次則出其觀¶體，
三則語其相應，
四則警其上慢，
五則誡其¶疎怠，
六則重出觀體，
七則明其是非，
八則簡¶
其詮旨，
九則觸途成觀，
十則妙契玄源。¶

第一、
言法爾者，
夫心性虛通，
動靜之源莫二；
¶真如絕慮，
緣計之念非殊。
惑見紛馳，
窮之則¶唯一寂；
靈源不狀，
鑒之則以千差。
千差不同，
¶法眼之名自立；
一寂非異，
慧眼之號斯存。
理¶量雙銷，
佛眼之功圓著。
是以三諦一境，
法身¶之理常清；
三智一心，
般若之明常照。
境智冥
<pb:ZB6q0003_T_005-0242a>
¶合，
解脫之應隨機；
非縱非橫，
圓伊之道玄會。
¶故知三德妙性，
宛爾無乖，
一心。
深廣難思，
何¶出要而非路？
是以即心為道者，
可謂尋流而¶得源。¶

第二、
出其觀體者，
只知一念即空不空、
非空¶非不空。¶


第三、
語其相應者，
心與空相應，
則譏毀讚譽¶何憂何喜？
身與空相應，
則刀割香塗何苦何¶樂？
依報與空相應，
則施與劫奪何得何失？
心¶與空不空相應，
則愛見都忘，
慈悲普救；
身與¶空不空相應，
則內同枯木，
外現威儀；
依報與¶空不空相應，
則永絕貪求，
資財給濟。
心與空¶不空、
非空非不空相應，
則
實相初明，
開佛知¶見；
身與空不空、
非空非不空相應，
則一塵入¶正受，
諸塵三昧起；
依報與空不空、
非空非不¶空相應，
則香臺寶閣，
嚴土化生。¶

第四、
警其上慢者，
若不爾者，
則未相應也。¶

第五、
誡其疎怠者，
然渡海應上船，
非船何以¶能渡？
修心必須入觀，
非觀何以明心？
心尚未¶明，
相應何日？
思之，
勿自恃也。¶

第六、
重出觀體者，
只知一念即空不空，
非有¶非無，
不知即念即空不空，
非非有非非無。¶

第七、
明其是非者，
心不是有，
心不是無，
心¶不非有，
心不非無。
是有是無，
即墮是；
非有¶非無，
即墮非。
如是只是是非之非，
未是非是¶非非之是。
今以雙非破兩是，
是破非是，
猶是¶非。
又以雙非破兩非，
非破非非，
即是是。
如是¶只是非是非非之是，
未是不非不不非，
不是¶不不是。
是非之惑，
綿微難見，
神清慮靜，
細而
<pb:ZB6q0003_T_005-0242b>
¶研之。¶


第八、
簡其詮旨者，
然而，
至理無言，
假文言以¶明其旨；
旨宗非觀，
藉修觀以會其宗。
若旨之¶
未明，
則言之未的；
若宗之未會，
則觀之未深。
¶深觀乃會其宗，
的言必明其旨。
旨宗既其明¶會，
旨觀何得復存耶？¶

第九、
觸途成觀者，
夫再演言詞，
重標觀體，
欲¶明宗旨無異，
言觀，
有逐方移。
方移，
則言理無¶差；
無差，
則觀旨不異。
不異之旨即理，
無差之¶理即宗，
旨一而二名，
言觀明其弄胤耳。¶

第十、
妙契玄源者，
夫悟心之士，
寧執觀而迷¶旨？
達教之人，
豈滯言而惑理？
理明則言語道¶斷，
何言之能議？
旨會則心行處滅，
何觀之能¶思？
心言不能思議者，
可謂妙契寰中矣。¶

師先天二年十月十七日安坐示滅。
十一月¶十三日，
塔于西山之陽。
勅諡無相大師，
塔曰¶淨光。
宋朝淳化中，
太宗皇帝詔本州重修龕¶塔。
¶

司空山本淨禪師者，
絳州人也，
姓張氏。
幼歲¶披緇，
于曹谿之室受記，
隸司空山無相寺。
唐¶天寶三年，
玄宗遣中使楊光庭入山采常春¶藤，
因造丈室禮問曰︰
「弟子慕直斯久，
願和尚¶
慈悲，
略垂開示。」

師曰︰
「天下禪宗碩學，
咸會京¶師，
天使歸朝，
足可咨決。
貧道隈山傍水，
無所¶用心。」
光庭泣拜。

師曰︰
「休禮貧道！
天使為求佛¶邪？
問道邪？」

曰︰
「弟子智識昏昧，
未審佛之與道¶其議云何？」

師曰︰
「若欲求佛，
即心是佛；
若欲會¶道，
無心是道。」

曰︰
「云何即心是佛？」

師曰︰
「佛因心¶悟，
心以佛彰。
若悟無心，
佛亦不有。」


曰︰
「云何無
<pb:ZB6q0003_T_005-0242c>
¶心是道？」

師曰︰
「道本無心，
無心名道。
若了無心，
¶無心即道。」

光庭作禮信受。
既迴闕，
庭具以山¶中所遇奏聞，
即勅光庭詔師。
十二月十三¶日到京，
勅住白蓮亭。
越明年正月十五日，
召¶兩街名僧碩學。
赴內道場與師闡揚佛理。

時¶有遠禪師者，
抗聲謂師曰︰
「今對聖上校量宗¶旨，
應須直問直答，
不假繁辭，
只如禪師所見¶以何為道？」

師答曰︰
「無心是道。」

遠曰︰
「道因心¶有，
何得言無心是道？」

師曰︰
「道本無名，
因心名¶道；
心名若有，
道不虛然。
窮心既無，
道憑何立？
¶二俱虛妄，
總是假名。」

遠曰︰
「禪師見有身心，
是¶道以
否？」

師曰︰
「山僧身心本來是道。」

曰︰
「適言¶無心是道，
今又言身心本來是道，
豈不相違？」

¶
師曰︰
「無心是道，
心泯道無；
心道一如，
故言無¶心是道。
身心本來是道，
道亦本是身心；
身心¶本既是空，
道亦窮源無有。」

曰︰
「觀禪師形質甚¶小，
却會此理。」

師曰︰
「大德。
只見山僧相，
不見¶山僧無相。
見相者，
是大德所見。
經云︰
『凡所有¶相，
皆是虛妄。
若見諸相非相，
即悟其道。』
若以¶相為實，
窮劫不能悟道。」

曰︰
「今請禪師於相上¶說於無相。」

師曰︰
「《淨名經》云︰
『四大無主，
身亦無¶我。
無我所見，
與道相應。』
大德！
若以四大有主¶是我，
若有我見，
窮劫不可會道也。」
遠公聞語¶失色，
逡巡避席。

師有偈曰︰¶
#+BEGIN_VERSE

　四大無主復如水，
　遇曲逢直無彼此。¶
　淨穢兩處不生心，
　壅決何曾有二意？¶

　觸境但似水無心，
　在世縱橫有何事？
#+END_VERSE¶

復云︰
「一大如是，
四大亦然。
若明四大無主，
即¶悟無心；
若了無心，
自然契道。」

又有志明禪師
<pb:ZB6q0003_T_005-0243a>
¶者。
問曰︰
「若言無心是道，
瓦礫無心，
亦應是
道。
¶又云。
身心本來是道，
四生十類皆有身心，
亦¶應是道。」

師曰︰
「大德若作見聞覺知之解，
與道¶懸殊。
即是求見聞覺知之者，
非是求道之人。
¶經云︰
『無眼、
耳、鼻、
舌、身、
意。』
六根尚無，
見聞覺知¶憑何而立？
窮本不有，
何處存心？
焉得不同草¶木瓦礫？」
志明杜口而退。

師又有偈曰︰¶
#+BEGIN_VERSE

　見聞覺知無障礙，
　聲香味觸常三昧。¶
　如鳥空中只麼飛，
　無取無捨無憎愛。¶
　若會應處本無心，
　始得名為觀自在。
#+END_VERSE¶

又有真禪師者。
問云︰
「道既無心，
佛有心否？
佛¶之與道，
是一是二？」

師曰︰
「不一不異。」


曰︰
「佛度眾¶生，
為有心故；
道不度人，
為無心故。
一度一不¶度，
何得無二？」

師曰︰
「若言佛度眾生，
道無度者，
¶此是大德妄生二見。
如山僧即不然，
佛是虛¶名，
道亦妄立，
二俱不實，
總是假名。
一假之中，
¶何分二？」

問曰︰
「佛之與道，
從是假名，
當立名時，
¶是誰為立？
若有立者，
何得言無？」

師曰︰
「佛之與¶道，
因心而立，
推窮立心，
心亦是無。
心既是無，
¶即悟二俱不實，
知如
夢幻，
即悟本空。
彊立佛、
¶道二名，
此是二乘人見解。」

師乃說無修無作。
¶偈曰︰¶
#+BEGIN_VERSE
　見道方修道，
　不見復何修？¶
　道性如虛空，
　虛空何所修？¶
　遍觀修道者，
　撥火覓浮漚。¶
　但看弄傀儡，
　線斷一時休。¶
#+END_VERSE

又有法空禪師者。
問曰︰
「佛之與道，
俱是假名，
¶十二分教亦應不實，
何以從前尊宿皆言修¶道？」


師曰︰
「大德錯會經意。
道本無修，
大德彊修；
<pb:ZB6q0003_T_005-0243b>
¶道本無作，
大德彊作；
道本無事，
彊生多事；
道¶本無知，
於中彊知。
如此見解，
與道相違。
從前¶尊宿不應如是，
自是大德不會，
請思之。」
師又¶有偈曰︰¶
#+BEGIN_VERSE
　道體本無修，
　不修自合道。¶
　若起修道心，
　此人不會道。¶
　棄却一真性，
　却入鬧浩浩。¶
　忽逢修道人，
　第一莫向道。
#+END_VERSE¶

又有安禪師者。
問曰︰
「道既假名，
佛云妄立，
十¶二分教亦是接物度生，
一切是妄，
以何為真？」

¶師曰︰
「為有妄故，
將真對妄。
推窮妄性本空，
真¶亦何曾有故？
故知真妄總是假名，
二事對治，
¶都無實體，
窮其根本，
一切皆空。」

曰︰
「既言一切¶是妄，
妄亦
同真。
真妄無殊，
復是何物？」

師曰︰
「¶若言何物，
何物亦妄。
經云︰
『無相似，
無比況，
言¶語道斷，
如鳥飛空。』」
安公慚伏，
不知所措。


師又¶有偈曰︰¶
#+BEGIN_VERSE

　推真真無相，
　窮妄妄無形。¶
　返觀推窮心，
　知心亦假名。¶
　會道亦如此，
　到頭亦只寧。
#+END_VERSE¶

又有達性禪師者。
問曰︰
「禪是至妙至微，
真妄¶雙泯，
佛道兩亡，
修行性空，
名相不實，
世界如¶幻，
一切假名，
作此解時，
不可斷絕眾生善惡¶二根。」

師曰︰
「善惡二根，
皆因心有，
窮心若有，
根¶亦非虛，
推心既無，
根因何立？
經云︰
『善不善法，
¶從心化生。』
善惡業緣，
本無有實。」
師又有偈曰︰¶
#+BEGIN_VERSE

　善既從心生，
　惡豈離心有？¶
　善惡是外緣，
　於心實不有。¶
　捨惡送何處？
　取善令誰守？
<pb:ZB6q0003_T_005-0243c>
¶
　傷嗟二見人，
　攀緣兩頭走。¶
　若悟本無心，
　始悔從前咎。
#+END_VERSE¶

又有近臣。
問曰︰
「此身從何而來？
百年之後，
復¶歸何處？」

師曰︰
「如人夢時從何而來？
睡覺時從¶何而去？」


曰︰
「夢時不可言無，
既覺不可言有，
雖¶有有無，
來往無所。」

師曰︰
「貧道此身，
亦如其夢。」¶
又有偈曰︰¶
#+BEGIN_VERSE

　視生如在夢，
　夢裏實是鬧。¶
　忽覺萬事休，
　還同睡時悟。¶
　智者會悟夢，
　迷人信夢鬧。¶
　會夢如兩般，
　一悟無別悟。¶
　富貴與貧賤，
　更亦無別路。
#+END_VERSE¶

上元二年五月五日歸寂，
勅諡大曉禪師。¶

婺州玄策禪師者，
婺州金華人也。
出家遊方，
¶屆于河朔，
有智隍禪師者，
曾謁黃梅五祖，
庵¶居二十年，
自謂正受。
師知隍所得未真，
往問¶曰︰
「汝坐於此作麼？」

隍曰︰
「入定。」

師曰︰
「汝言入¶定，
有心耶？
無心耶？
若有心者，
一切蠢動之類¶皆應得定；
若無心者，
一切草木之流亦合得¶定。」


曰︰
「我正入定時，
則不見有有無之心。」

師曰︰
「¶既不見有有無之心，
即是常定，
何有出入？
若¶有出入，
則非大定。」

隍無語，
良久，
問︰
「師嗣誰？」

師¶曰︰
「我師曹谿六祖。」

曰︰
「六祖以何為禪定？」

師曰︰
「¶我師云︰
『夫妙湛圓寂，
體用如如。
五陰本空，
六¶塵非有，
不出不入，
不定不亂。
禪性無住，
離住¶禪寂；
禪性無生，
離生禪想。
心如虛空，
亦無虛¶空之量。』」

隍聞此說，
遂
造于曹谿，
請決疑翳，
¶而祖意與師冥符，
隍始開悟。
師後却歸金華，
¶大開法席。
<pb:ZB6q0003_T_005-0244a>
¶

曹谿令韜禪師者，
吉州人也，
姓張氏。
依六祖¶出家，
未嘗離左右，
祖歸寂，
遂為衣塔主。
唐開¶元四年，
玄宗聆其德風，
詔令赴闕，
師辭疾不¶起。
上元元年，
肅宗遣使取傳法衣入內供養，
¶仍勅師隨衣入朝，
師亦以疾辭，
終于本山，
壽¶九十五，
勅諡大曉禪師。
¶
*** 西京光宅寺慧忠國師	Landesmeister Huizhong vom Guangzhe Tempel in der westlichen Hauptstadt
西京光宅寺慧忠國師者，	Landesmeister Huizhong vom Guangzhe Tempel in der westlichen Hauptstadt
越州諸暨人也，	stammte aus Zhuji in Yuezhou,
姓¶冉氏。	sein Familienname war Ran.
自受心印，	Nachdem er die Übertragung des Geistessiegel erhalten hatte,
居南陽白崖山黨子谷，	lebte er im Dangzi Tal am Berg Baiya in Nanyang.
四十¶餘祀不下山門，	Für mehr als 40 Jahre verließ er den Tempel nicht,
道行聞于帝里。	aber der Ruf seiner spirituellen Errungenschaft erreichte die Hauptstadt.
**** 
唐肅宗上元¶二年，	Im 2. Jahr der Ära Shangyuan unter dem Tang-Kaiser Suzong,
#== 761
勅中使孫朝進。	der Kaiser erließ ein Edikt mit dem Sun Chaojin 
齎詔徵赴京，	beauftragt wurde, Huizhong zur Hauptstadt zu eskortieren,
待以師禮。	damit der Kaiser dem Meister huldigen könne.

¶初居千福寺西禪院，	Zunächst lebte er in der westlichen Chan Halle des Qianfu Tempels,
及代宗臨御，	aber als Daizong ihn besuchen wollte,
#== 763-779
復迎止光¶宅精藍。	wurde er eingeladen, im Guangzhe Tempel zu wohnen.
十有六載，	Für 16 Jahre 
隨機說法。	predigte er dort das Dharma gemäß der Fähigkeit seiner Audienzen.
**** 
時有西天大耳¶三藏。	Zu jener Zeit kam ein Tripiṭaka Meister aus Indien namens Daer
到京，云得他心慧眼，	in die Hauptstadt, der behauptete, er hätte ein Weisheitsauge, mit dem er die Gedanken anderer lesen könnte.
帝勅令與國師試¶驗。	Der Kaiser befahl Landesmeister Huizhong einen Test mit ihm zu machen.
三藏才見師便禮拜，	Daer sah Huizhong und machte sofort eine tiefe Verbeugung,
立于右邊，	dann stellte er sich an seine rechte Seite.
師問曰︰	Huizhong fragte:
「¶汝得他心通耶？」	"Du hast also die Fähigkeit, die Gedanken anderer lesen zu können?"

對曰︰	Er erwiderte 
「不敢。」	"Ich wage es nicht, in aller Bescheidenheit dies zu bestätigen."

師曰︰	Huizhong fragte:
「汝道老僧即¶今在什麼處？」	"So sage mir, wo ich mich im Moment befinde?"

曰︰	Daer antwortete:
「和尚是一國之師，	"Ehrwürden ist der Meister des Landes,
何得却去¶西川看競渡？」	wie kommt es, daß Sie zum Westfluß gegangen sind, um das Bootrennen zu sehen?"

師再問︰	Huizhong fragte ein weiteres Mal:
「汝道老僧	"So sage mir noch einmal,
即今在什麼¶處？」	wohin bin ich jetzt gegangen?"

曰︰	Daer antwortete:
「和尚是一國之師，	"Ehrwürden ist der Meister des Landes,
何得却在天津橋上¶看弄猢猻？」	wie kommt es, daß Sie zur Tianjin Brücke gegangen sind, um das Affentheater zu sehen?"

師第三問語亦同前，	Huizhong fragte ein drittes Mal,
三藏良久罔¶知去處，	aber diesmal zögerte Daer lange und wußte nicht, wie er sich herauswinden könnte.
師叱曰︰	Huizhong beschimpfte ihn und sagte:
「遮野狐精！	"Du bist der Geist eines wilden Fuchses!
他心通在什麼¶處？」	Wo ist deine Kunst, die Gedanken anderer zu lesen?"
三藏無對。	Daer hatte keine Antwort.

(僧問仰山曰︰	(Ein Mönch fragte Yangshan:	
「大耳三藏第三度為什麼不見國師？」	"Warum konnte Tripiṭaka-Meister Daer beim dritten Mal den Landesmeister nicht sehen?"

仰山曰︰	Yangshan antwortete:
「前兩度是涉境心，	"Die beiden ersten Male ist er im Geiste im Bereich der physikalischen Welt geblieben,
¶後入自受用三昧，	aber beim dritten Mal ist er selbst in Samadhi eingetreten,
所以不見。」	da konnte dieser ihn nicht sehen."

又有僧舉前語問玄沙，	Ein anderes Mal richtete ein Mönch dieselbe Frage an Xuansha,
玄沙曰︰	Xuansha antwortete:
「汝道前兩度還見麼？」	"Sag mal, kannst du die beiden ersten Male noch sehen?"

玄覺云︰	Xuanjue sagte:
「前兩度若見，	"Wenn er ihn die ersten beiden Male sehen konnte,
後來為什¶麼不見？	warum konnte er ihn beim letzten Mal nicht sehen?
且道利害在什麼處？」	Und wer von den beiden hat schließlich gewonnen?"

僧問趙州曰︰	Ein Mönch fragte Zhaozhou:
「大耳三藏第三度不見國師，	"Als der Tripiṭaka-Meister Daer ihn beim dritten Male nicht sehen konnte,
未審國師在什麼處？」	ich möchte wohl wissen, wo sich der Landesmeister da versteckt hat."

趙州云︰	Zhaozhou antwortete:
「在三藏鼻孔¶上。」	"Im Nasenloch von Daer"

僧問玄沙︰	Ein Mönch fragte Xuansha:
「既在鼻孔上，	"Wenn er denn im Nasenloch war,
為什麼不見？」	warum konnte Daer ihn dann nicht sehen?"

玄沙云︰	Xuansha sagte:
「只為太近。」)	"Er war zu dicht dran.")
**** 
一日，	Eines Tages
喚侍者，	rief er seinen Aufwärter,
侍者應¶諾，	und der Aufwärter antwortete.
如是三召，	Dies wiederholte sich drei Mal,
皆應諾。	und jedes Mal antwortete er.
師曰︰	Schließlich sagte Huizhong:
「將謂吾孤負汝，	"Ich dachte, ich hätte dich enttäuscht,
却¶是汝孤負吾。」	aber jetzt sehe ich, daß du mich enttäuscht."


(僧問玄沙︰	(Ein Mönch fragte Xuansha:
「國師喚侍者，	"Als der Landesmeister seinen Aufwärter rief,
意作麼生？」	was war seine Absicht?"

玄沙云︰	Xuansha sagte:
「却是侍者會。」	"Er wollte das Verständnis des Aufwärters prüfen."

雲居錫云︰	Yunju xi sagte:
「且道侍者¶會不會？	"Und was meinst du, hatt der Aufwärter es verstanden?
若道會，	Wenn du sagst ja,
國師又道汝孤負吾；	dann wird der Landesmeister wieder sagen, du hast mich enttäuscht,
若道不會，	sagst du aber nein,
玄沙又道却是侍者會。	dann wird Xuansha wieder sagen, der Aufwärter hat ihn enttäuscht.
且作麼生商量？」	Wie willst du dich da herauswinden?"

玄覺徵問僧︰	Xuansha fragte nun den Mönch zurück:
「什麼是侍者¶會處？」	"Was ist es denn, das der Mönch verstanden hat?"

僧云︰	Der Mönch sagte:
「若不會，	"Wenn er es nicht verstanden hätte,
爭解恁麼應？」	dann hätte er wohl auch nicht antworten können."
:zhu:
爭解 [zheng4xie4] koga : 266 // できるはずがない
:end:

玄覺云︰	Xuanjue sagte:
「汝少會在。」	"Du hast aber nicht viel verstanden."
又云︰	Weiterhin sagte er:
「若於這裏商量得去，	"Wenn wir uns hier einigen sollen,
便見玄沙。」	dann bin ich eher mit Xuansha."

僧問法眼︰	Ein Mönch fragte Fayan
「國師喚侍者，	"Als der Landesmeister den Aufwärter rief,
意<pb:ZB6q0003_T_005-0244b>¶作麼生？」	was hatte er da beabsichtigt?"

法眼云︰	Fayan antwortete:
「且去，	"Geh jetzt weg,
別時來。」	komm ein andermal wieder."

雲居錫云︰	Yunju xi sagte:
「法眼恁麼道，	"Was Fayan gesagt hat,
為復明國師意？	soll das vielleicht die Absicht des Landesmeisters erhellen?
不明國師意？」	Oder hat er die Absicht des Landesmeisters auch nicht verstanden?"

僧問趙州︰	Ein Mönch fragte Zhaozhou:
「國師喚侍者，	"Als der Landesmeister den Aufwärter rief,
意作麼¶生？」	was hatte er da für eine Absicht?"

趙州云︰	Zhaozhou sagte:
「如人暗裏書字，	"Wenn jemand im dunkeln Zeichen schreibt,
字雖不成，	so werden es keine richtigen Schriftzeichen,
文彩已彰。」)	sondern sieht eher aus wie ein Muster.")
**** 
南泉到參，	Nanquan kam, um seine Aufwartung zu machen,
師問︰	da fragte Huizhong:
「什麼處¶來？」	"Wo kommst du her?"

對曰︰	Nanquan antwortete:
「江西來。」	"Ich komme aus Jiangxi."

師曰︰	Huizhong fragte:
「還將得馬師真來否？」	"Hast du die Wahrheit von Meister Ma mitgebracht?"


曰︰	Er antwortete:
「¶只遮是。」	"Ich habe das, was nur dies ist."

師曰︰	Huizhong sagte:
「背後底？」	"Hast du auch das, was hinter dir ist?"
南泉便休。	Nanquan ließ es dabei bewenden.

(長慶稜云︰	(Zhang Qing sagte zustimmend:
「大似不知。」	"Die sehen sich sehr ähnlich!"

¶保福展云︰	Baofu fügte hinzu:
「幾不到和尚此間。」	"Nicht viele reichen an diese beiden heran."
#==TODO
雲居錫云︰	Yunju xi sagte:
「此二尊者盡扶背後，	"Diese beiden Ehrwürden spielen sich hinter ihrem Rücken gegenseitig zu,
只如南泉休去，	aber als Nanquan aufgibt,
為當扶面前？	wer spielt dann vorne weiter?
扶背後？」)	Und hinter wessen Rücken?")
**** 
麻谷¶到參，	Magu kam, um seine Aufwartung zu machen.
繞禪床三匝，	Er ging um den Meditationssitz dreimal herum,
於師前振錫而立，	dann schüttelte er seinen Stock und stellte er sich vor dem Meister auf.
師曰︰	Der Meister sagte:
「既¶如是，	"Wenn du dich so benimmst,
何用更見貧道？」	was versprichst du dir davon, mich armen Mönch zu besuchen?"
麻谷又振錫。	Magu schüttelte wieder seinen Stock.

師叱曰︰	Der Meister schrie:
「遮¶野狐精，	"He, Fuchsgeist,
出去！」	geh weg!"
**** 
師每示眾云︰	Huizhong sagte zu seiner Versammlung:
「禪宗學者，	"Adepten des Weges,
應遵佛¶語。	ihr müßt euch an die Worte Buddhas halten.
一乘了義，	Versteht die Bedeutung des Einen Fahrzeug,
契自心源；	und dringt zur Wurzel eures Geistes vor.
不了義者，	Wenn ihr dies nicht versteht,
互不相許，	dann habt ihr die Lehren nicht verwirklicht
¶如獅子身蟲。	und ihr seid wie ein Löwe mit dem Körper einer Schlange.
夫為人師者，	Wenn ihr [in diesem Zustand] Lehrer anderer werdet,
若涉名利，	und vielleicht sogar einen gewissen Ruhm erlangt,
別開¶異端，	aber selbst noch nicht alle Zweifel ausgeräumt habt,
則自他何益？	was für einen Nutzen soll das haben?
如世大匠，	Ein geschickter Zimmermann
斤斧不傷其手。	verletzt sich nicht selbst mit seiner Axt.
¶香象所負，	Was der edle Elephant trägt,
:zhu:
香象 [xiang1xiang4] cf [[mandoku:cbeta:T10n0279:0160b09][Taisho Tripitaka, Electronic version, No. 0279 大方廣佛華嚴經 T10n0279:0160b09]]
:end:
非驢能堪。」	kann ein Esel nicht aushalten."
**** 
有僧問︰	Ein Mönch fragte:
「若為得成佛去？」	Wie wird man ein Buddha?"

¶
師曰︰	Huizhong antwortete:
「佛與眾生，	"Wenn du Buddha und alle Lebewesen
一時放却，	auf einmal abwirfst,
當處解脫。」	dann bist du sofort befreit."
**** 
問︰	Frage:
「作麼¶生得相應去？」	"Wie kann ich in Einklang damit sein?"

師云︰	Huizhong antwortete:
「善惡不思，	"Wenn du nicht über Gut und Schlecht nachdenkst,
自見佛性。」	dann wirst du selbst die Buddha-Natur sehen."

問︰	Frage:
「若¶為得證法身？」	"Wie kann ich den Dharmakāya bezeugen?"

師曰︰	Huizhong antwortete:
「越毘盧之境界。」	"Du brauchst nur über die Welt des Buddha Vairocana hinauszugehen."

曰︰	Frage:
「清淨法¶身作麼生得？」	"Wie kann ich den reinen Dharmakāya erreichen?"

師曰︰	Huizhong antwortete:
「不著佛求耳。」	"Höre nur auf, nach Buddhaschaft zu streben."

問︰	Frage:
「阿那箇是¶佛？」	"Was ist der Buddha?"

師曰︰	"Huizhong:
「即心是佛。」	"Der Geist ist der Buddha."

曰︰	Frage:
「心有煩惱否？」	"Gibt es verunreinigende Leidenschaften im Geist?"

師曰︰	Huizhong sagte:
「煩¶惱性自離。」	"Die Natur der verunreinigenden Leidenschaften wird von selbst verschwinden."

曰︰	Frage:
「豈不斷耶？」	"Wieso sollen wir sie nicht abtrennen?"

師曰︰	Huizhong antwortete:
「斷煩惱者，	"Wer die verunreinigenden Leidenschaften abtrennt,
即名¶二乘；	der ist ein Adept der zwei Fahrzeuge,
煩惱不生，	Leidenschaften entstehen aber nicht,
名大涅槃。」	das ist das große Nirvana."

問︰	Frage:
「坐禪看靜，	"Wie verhält es sich mit dem praktizieren sitzender Meditation und der Betrachtung der Stille?"
此復¶若為？」


師曰︰	Huizhong antwortete:
「不垢不淨，	"Es ist nicht verunreinigt und nicht rein,
寧用起心而看淨相？」	würdest du nicht besser deinen Geist erheben, so daß du die Reinheit sehen kannst?"

又¶問︰	Er fragte weiter;
「禪師見十方虛空是法身否？」	"Verehrter Chan Meister, ist nach ihrer Ansicht der Weltraum in alle Richtungen erfüllt vom Dharmakāya?"

師曰︰	Huizhong antwortete:
「以想心¶取之，	"Wenn du nur intellektuel darüber nachdenkst,
是顛倒見。」	dann bekommst du ein vollkommen falsches Bild davon."

問︰	Frage:
「即心是佛，	"Wenn der Geist schon Buddha ist,
可更修萬行否？」	soll man dann überhaupt noch die vielfältigen Übungen machen?"

¶師曰︰	Huizhong antwortete:
「諸聖皆具二嚴，	"Alle Heiligen haben diesen doppelte Schmuck,
:zhu:
二嚴 [er4yan3] == Weisheit und gute Taten
:end:
豈撥無因果耶？」	warum sollten sie das Kausalgesetz verneinen?"

又曰︰	Er sagte weiterhin:
「我¶今答汝，	"Wenn ich eure Fragen weiterhin beantworte,
窮劫不盡，	dann wird davon kein Ende sein, auch wenn es Ewigkeiten weiterginge.
言多去道遠矣。	Je mehr man spricht, desto weiter entfernt man sich vom Weg.
所以道︰	Daher wurde gesagt:
說¶法有所得，	'Das was durch Predigen mit einer Absicht erreicht wird,
斯則野干鳴；	ist nicht anders als der Schrei eines wilden Fuchses.
說法無所得，	Was aber durch Predigen ohne Absicht erreicht wird,
是名師¶子吼。」	wird das Brüllen eines edlen Löwen genannt."
**** 
南陽張濆行者問︰	Ein Übender aus Nanyang namens Zhang Pen fragte:
:zhu:
行者 [xing4zhu1] Erläuterung: 禪林中，行者乃指未出家而住於寺內幫忙雜務者。有剃髮者，亦有未剃髮而攜家帶眷者。
:end:
「伏承和尚說無情說¶法，	"Ich habe gehört, daß Sie, Ehrwürden, auch nicht fühlenden Lebewesen predigen,
某甲未體其事，	habe es aber selbst nie gesehen,
乞和尚垂示。」	ich bitte Sie, zeigen Sie mir doch, wie Sie das machen."

師曰︰	Huizhong sagte:
「汝若問¶無情說法，	"Da du nach dem Predigen für nicht fühlende Lebewesen fragst, 
解他無情，	so wisse, das Verstehen muß auch nicht fühlend sein.
方得聞我說法，	Wenn du mich daher  predigen hören willst,
汝但聞¶取無情說法去。」	so brauchst du nur ohne zu fühlen meiner Predigt zuzuhören.

濆曰︰	Zhang Pen sagte:
「只約如今有情方便之<pb:ZB6q0003_T_005-0244c>¶中，	"Was fühlende Lebewesen angeht, so können Sie einfach ihren Fähigkeiten folgen,
如何是無情因緣？」	wie stellen Sie aber eine Beziehung zu nicht fühlenden Lebewesen her?"

師曰︰	Huizhong antwortete:
「如今一切動用之¶中，	"So wie es im Moment steht, gibt es unter allen Anwendungen,
但凡聖兩流都無少分起滅，	von gewöhnlichen Menschen oder Heiligen, nicht den kleinsten Anstoß dafür.
便是出識，	Das liegt daran, daß diese keine Informationen von außen aufnehmen
不¶屬有無，	und nicht unter die Kategorien von Sein oder Nicht-Sein fallen.
熾然見覺，	Sie sind sich sehr intensiv ihrer selbst bewußt,
只聞無其情識繫執。	nur hören wir, daß sie keine Gefühle haben und auch keine Erinnerung.
所以¶六祖云︰	Daher sagte der sechste Patriarch:
『六根對境，	'Wenn die sechs Sinne mit der Außenwelt in Kontakt treten,
分別非識。』」	dann ist das Wahrnehmen, aber kein Wissen.'"
**** 
有僧到參禮，	Ein Mönch kam und verbeugte sich.
師¶問︰		Huizhong fragte ihn:
「蘊何事業？」	"Mit was für einer Sache beschäftigen Sie sich?"

曰︰	Er antwortete:
「講《金剛經》。」	"Ich lehre über das /Diamant Sutra/."


師曰︰	Huizhong fragte:
「最初兩字是¶什麼？」	"Was sind die ersten beiden Zeichen?"

曰︰	Er antwortete:
「如是。」	"So ist es."

師曰︰	Huizhong fragte:
「是什麼？」	"Was bedeutet diese 'so'?"
無對。	Der Mönch hatte keine Antwort.
**** 
有人問︰	Jemand fragte:
「如¶何是解脫？」	"Was ist mit 'Befreiung' gemeint?"

師曰︰	Huizhong sagte:
「諸法不相到，	"Before alle Dharmas zusammenkommen,
當處解脫。」	sind wir schon ursprünglich befreit."

曰︰	Er sagte:
「恁¶麼即斷去也。」	"Das heißt also, daß diese nun abgeschnitten sind."

師曰︰	Huizhong sagte:
「向汝道諸法不相到，	"Ich sagte doch, daß die Dharmas noch nicht zusammengekommen sind,
斷什¶麼？」	wo ist da die Rede von 'abschneiden'?"
**** 
師見僧來，	Huizhong sah einen Mönch kommen,
以手作圓相，	und malte mit den Händen einen Kreis,
相中書日字，	in den Kreis schrieb er das Zeichen für 'Sonne'.
僧無¶對。	Der Mönch sagte nichts.
**** 
師問本淨禪師︰	Huizhong fragte Chan Meister Benjing:
「汝已後見奇特言語如何？」	"Was tun Sie, wenn Sie feststellen, daß Ihnen schmeichelhafte Reden folgen?"

¶淨曰︰	Benjing sagte:
「無一念心愛。」	"Ich habe kein bißchen Interesse daran."

師曰︰	Huizhong sagte:
「是汝屋裏事。」	"Das ist Ihre Sache."
**** 
肅宗問︰	Kaiser Suzong fragte:
「¶師得何法？」	"Wessen Lehre haben Sie empfangen?"

師曰︰	Huizhong sagte:
「陛下見空中一片雲麼？」	"Majestät, sehen Sie die Wolke da hinten?"

帝曰︰	Der Kaiser antwortete:
「¶見。」	"Ja."

師曰︰	Huizhong fragte:
「釘釘著？	"Ist die da festgenagelt?
懸掛著？」	oder nur aufgehängt?"

又問︰	Der Kaiser fragte weiterhin:
「如何是十身調¶御？」	"Was sind die zehn Aspekte des Körpers der Lebewesen?"
:zhu:
調御 [zhou1yu4] dfb: 一切眾生，譬如狂象惡馬。佛譬如象馬師而調御之也。
:end:

師乃起立曰︰	Huizhong stand auf und sagte:
「還會麼？」	"Haben Sie verstanden?"

曰︰	Der Kaiser sagte:
「不會。」	"Nein."

師曰︰	Huizhong sagte:
「與老¶僧過淨瓶來。」	"Geben Sie doch bitte mir altem Mönch die Flasche dort drüben."

又曰︰	Der Kaiser fragte weiterhin:
「如何是無諍三昧？」	"Was ist das Samādhi ohne Dispute?"

師曰︰	Huizhong sagte:
「檀¶越蹋毘盧頂上行。」	"Mein Wohltäter, Sie treten auf den Kopf von Vairocana Buddha."
:zhu:
檀越 [tan3yue4] // Danka, Dānapati, 謂施主也。
:end:

曰︰	Der Kaiser fragte:
「此意如何？」	"Was soll das heißen?"

師曰︰	Huizhong antwortete:
「莫認自¶己清淨法身。」	"Sie kennen Ihren eigenen ungestörten Dharmakāya noch nicht!"
**** 
又問師，	Als [der Kaiser] wieder einmal dem Meister Fragen stellte,
師都不視之。	sah ihn dieser überhaupt nicht an.
曰︰	Er sagte:
「朕是¶大唐天子，	"Ich bin der Kaiser der großen Tang Dynastie,
師何以殊不顧視？」	warum schauen Sie mich nicht an, Meister?"

師曰︰	Huizhong sagte:
「還見虛空¶麼？」	"Haben Sie schon einmal in den Himmel geschaut?"

曰︰	Der Kaiser:
「見。」	"Ja."

師曰︰	Huizhong sagte:
「他還眨目視陛下否？」	"Hat der Ihnen jemals zugezwinkert?"
**** 
魚軍容¶問︰	Yu Zhongrong fragte:
「師住白崖山，	"Meister, als Sie am Baiya Berg wohnten,
十二時中如何修道？」	wie haben Sie da 24 Stunden lang praktiziert?"

師喚童¶子來，	Der Meister rief den Aufwärterjungen herbei, 
摩頂曰︰	streichelte ihm über den Kopf und sagte:
「惺惺直然惺惺，	"Sei aufmerksam, wenn du aufmerksam sein sollst,
歷歷直然歷歷，	sei konzentriert, wenn du konzentriert sein sollst,
¶已後莫受人謾。」	dann wirst du niemals von anderen Leuten beleidigt werden."
**** 
師與紫璘供奉論義，	Huizong sollte an einer Debatte mit Cilin Gongfeng teilnehmen.
:zhu:
供奉 [gong4peng3] == Vielleicht ist Gongfeng die Bezeichnung für den Beauftragten für religiöse Fragen
:end:
既陞坐，	Nachdem sie ihre Plätze eingenommen hatten,
¶供奉曰︰	sagte Cilin:
「請師立義，	"Meister, bitte eröffnen Sie die Debatte und geben Sie uns Ihre These,
某甲破。」	ich werde sie dann widerlegen."

師曰︰	Der Meister sagte:
「立義竟。」	"Meine These ist aufgestellt."

供奉¶曰︰	Cilin sagte:
「是什麼義？」	"Aber was ist das für eine These?"

師曰︰	Huizong sagte:
「果然不見！	"Das ist in der Tat so!
非公境界。」	Wir sind hier nicht auf gemeinsamen Gebiet!"
便¶下坐。	Und damit verließ er die Debatte.
**** 
一日，	Eines Tages
師問紫璘供奉︰	fragte Huizong Cilin Gongfeng:
「佛是什麼義？」	"Was bedeutet 'Buddha'?"

曰︰	Cilin antwortete:
「是¶覺義。」	"Das bedeutet 'der Erwachte'."

師曰︰	Huizhong sagte:
「佛曾迷否？」	"War denn der Buddha einmal verwirrt?"

曰︰	Cilin:
「不曾迷。」	"Nein, er war niemals verwirrt."

師曰︰	Huizhong sagte:
「用覺¶作麼？」	"Und zu was ist er erwacht?"
無對。	Cilin antwortete nicht.

又問︰	Ein andermal fragte er:
「如何是實相？」	"Was ist die wahre Form?"

師曰︰	Huizhong antwortete:
「把將虛¶底來。」	"Bring mir die Weite des Raums her."

曰︰	Cilin sagte:
「虛底不可得。」	"Die Weite des Raums kann man nicht greifen."

師曰︰	Huizhong sagte:
「虛底尚不可得，	"Wenn man die Weite des Raumes nicht erlangen kann,
問¶實相作麼？」	was soll dann das Fragen nach der wahren Form?"
**** 
僧問︰	Ein Mönch fragte:
「如何是佛法大意？」	"Was ist die Bedeutung der Lehre Buddhas?"

師曰︰	Huizhong antwortete:
「文殊<pb:ZB6q0003_T_005-0245a>¶堂裏萬菩薩。」	"Das sind die zehntausend Bodhisattvas in der Mañjuśrī Halle."

曰︰	Der Mönch sagte:
「學人不會。」	"Das verstehe ich nicht."

師曰︰	Huizhong sagte:
「大悲千手眼。」	"Große Barmherzigkeit, tausend Hände und Augen."
**** 
¶耽源問︰	Danyuan fragte:
「百年後有人問極則事，	"Wenn in hundert Jahren jemand nach der wichtigsten Sache fragte, 
作麼生？」	wie würden Sie antworten?"

師曰︰	Huizhong sagte:
「¶幸自可憐生！	"Zum Glück muß der auf sich selbst aufpassen.
須要箇護身符子作麼？」	Was ist schon der Nutzen, den ein Talisman hat?"
**** 
師以化¶緣將畢，	Als Meister Huizhong fühlte, daß er an das Ende seiner Laufbahn als Prediger gekommen wae
涅槃時至，	und er ins Nirvana eingehen wollte,
乃辭代宗。	ging er zu Kaiser Daizong, um sich zu verabschieden.

代宗曰︰	Daizong fragte:
「師滅度，	"Meister, wenn Sie uns verlassen haben,
¶後弟子將何所記？」	was soll Ihr bescheidener Schüler zu Ihrer Erinnerung tun?"

師曰︰	Huizhong sagte:
「告檀越。	"Ich bitte Sie als mein Förderer,
造取一所無¶縫塔。」	bauen Sie eine nahtlose Pagode für mich."

曰︰	Der Kaiser sagte:
「就師請取塔樣。」	"Dann bitte ich Sie, machen Sie mir eine Skizze der Pagode."

師良久曰︰	Der Meister schwieg eine längere Zeit.  Dann fragte er:
「會麼？」	"Haben Sie verstanden?"

曰︰	Der Kaiser:
「¶不會。」	"Ich verstehe nicht."

師曰︰	Dann sagte Huizhong:
「貧道去後，	"Nachdem ich gegangen bin,
有侍者應真。	wenden Sie sich bitte an meinen Aufwärter Yingzhen,
却知此事。」	der weiß von dieser Angelegenheit.

¶大歷十年十二月九日，	Am 9. Tag des 12. Monats im 10. Jahr der Ära Dali
#==776
右脅長往。	starb der Meister, auf seiner rechten Seite liegend.
弟子奉靈¶儀於黨子谷建塔，	Die Schüler hielten das Begräbnis im Dangzi Tal und bauten dort eine Pagoda für ihn.
勅諡大證禪師。	Sein posthumer Titel war Chan Meister Dazheng.
**** 
代宗後詔¶應真入內，	Danach lud Kaiser Daizong Yingzhen in den Palast ein
舉問前語，	und erzählte ihm die oben erwähnte Angelegenheit.
真良久曰︰	Yingzhen schwieg lange, dann fragte er:
「聖上會麼？」	"Heilige Majestät, haben Sie verstanden?"

曰︰	Der Kaiser sagte:
「¶不會。」	"Ich verstehe nicht."

真述偈曰︰¶	Da rezitierte Yingzhen folgendes Gedicht für ihn:
#+BEGIN_VERSE
　湘之南，潭之北，	Südlich des Xiang Flusses, nördlich des Sees,
　中有黃金充一國。¶	da gibt es glänzendes Gold genug um den Staat zu füllen.
　無影樹下合同船，	Unter dem schattenlosen Baum wartet die Fähre,
　瑠璃殿上無知識。¶	in dem Palast aus Diamanten gibt es niemanden, der Bescheid weiß.
#+END_VERSE

應真後住耽源山。¶	Yinzhen lebte später auf dem Danyuan Berg.
*** TODO 西京荷澤神會禪師	Meister Shenhui vom Heze Tempel in der westlichen Hauptstadt
西京荷澤神會禪師者，	Meister Shenhui vom Heze Tempel in der westlichen Hauptstadt
襄陽人也，	stammte aus Xiangyang,
姓高氏。	sein Familienname war Gao.
年¶十四為沙彌，	Im Alter von 14 Jahren wurde er Novize.

謁六祖，	Später besuchte er den sechsten Patriarchen,
祖曰︰	Der Patriarch fragte ihn:
「知識遠來大艱辛，	"Oh Gelehrter, du bist aus weiter Ferne gekommen und hast viele Mühen auf dich genommen,
¶將本來否？	Hast du denn auch deine Wurzel mitgebracht?
若有本，	Wenn du die Wurzel hast,
則合識主，	dann wirst du deinen Meister kennen,
試說看。」	nun sag's doch mal."

師曰︰	Shenhui antwortete:
「以¶無住為本，	"Meine Wurzel ist die Unbeständigkeit,
見即是主。」	darin erkenne ich meinen Meister."

祖曰︰	Der Patriarch sagte:
「遮沙彌爭合取¶次語！」	"Dieser Novize kann wirklich argumentieren"
便以杖打。	und gab ihm einen Klaps mit seinem Stock.

師於杖下思惟曰︰	Während er den Schlag empfing, dachte Shenhui:
「大善知識¶歷劫難逢，	"Es geschieht nur nach vielen Äonen und unter großen Schwierigkeiten, daß man auf einen guten Lehrer trifft.
今既得遇，	Heute habe ich dieses Glück.
豈惜身命？」	Warum sollte ich mich an diesen Körper klammern?"
自此給侍。	Und hernach diente er dem sechsten Patriarchen als Aufwärter.
**** 
他¶日，	An einem anderen Tag
祖告眾曰︰	sagte der sechste Patriarch zu seiner Versammlung der Mönche:
「吾有一物，	"Es gibt dieses Ding,
無頭無尾，	das keinen Kopf hat und keinen Schwanz,
無名無字，	keinen Familiennamen und auch keinen Mannesnamen,
¶無背無面，	keine Rückseite und keine Vorderseite,
諸人還識否？」	wer von euch kann wohl sagen, was das ist?"

師乃出曰︰	Da sagte Shenhui:
「是諸佛之¶本原，	"Das ist der Ursprung des Buddha,
神會之佛性。」	die Buddhanatur des Shenhui."

祖曰︰	Der Patriarch sagte:
「向汝道無名無字，	"Ich sagte doch, daß es keinen Familiennamen und auch keinen Mannesnamen besitzt,
¶汝便喚本原佛性。」	und doch nennst du es die ursprüngliche Buddhanatur."
師禮拜而退。	Shenhui verbeugte sich und ging davon.
師尋往西京¶受戒，	Später ging er in die westliche Hauptstadt und erhielt dort die volle Ordination.
**** 
唐景龍中却歸曹谿。	Während der Ära Jinglong kam er zurück nach Caoxi.
#==707-710
祖滅後二十年間，	20 Jahre nach dem Tod des sechsten Patriarchen
¶曹谿頓旨沈廢於荊吳，	begann die Lehre von der unmittelbaren Erleuchtung aus Caoxi in den Gebieten von Jing und Wu an Bedeutung zu verlieren,
嵩嶽漸門盛行於秦¶洛，	während die Lehre von der allmählichen Erleuchtung vom Berg Song immer mehr Anhänger fand 
乃入京。	und auch in den Hauptstädten Eingang fand.

天寶四年，	Im 4. Jahr der Ära Tianbao,
方定兩宗，	waren die beiden Schulen 
(南能頓宗北秀漸教)	(nämlich Huinengs unmittelbare Lehre im Süden und Shenxius allmähliche Lehre im Norden) schon etabliert,
乃著《¶顯宗記》，	und dessen Werk /Aufzeichnungen von der Erscheinung der Lehre/
盛行于世。	war in der Welt weit verbreitet.
**** 
一日，	Eines Tages
鄉信至，	erhielt Shenhui einen Brief aus seiner Heimat,
報二親亡，	darin wurde ihm mitgeteilt, daß seine beiden Eltern gestorben seien.
師¶入堂白槌曰︰	Der Meister ging daraufhin in die Halle, klopfte mit dem Hammer an das Holzbrett und sagte:
:zhu:
白槌 [bo2zhui4] nachricht an alle
:end:
「父母俱喪，	"Meine Eltern sind beide gestorben,
請大眾念摩訶般<pb:ZB6q0003_T_005-0245b>¶若。」	ich bitte alle, sich zu versammeln, das /Mahaprajñā Sūtra/ zu rezitieren."

眾纔集，	Nachdem sich alle versammelt hatten,
師便打槌曰︰	schlug Shenhui wieder auf das Holzbrett und sagte:
「勞煩大眾。」	"Verzeihen Sie die Störung."

**** 
師於上元¶元年五月十三日中夜奄然而化，	Am 13. Tag des 5. Monats im 1. Jahr der Ära Shangyuan starb Shenhui in aller Ruhe kurz nach Mitternacht,
俗壽七十¶五。	er war 75 Jahre alt geworden.

二年，	Im 2. Jahr 
建塔於洛京龍門，	wurde eine Pagode in Longmen bei der östlichen Hauptstadt gebaut,
勅於塔所置寶應¶寺。	und auf kaiserlichen Befehl wurde dort ein neuer Tempel gebaut, der Baoying genannt wurde.

大歷五年，	Im 5. Jahr der Ära Dali
賜號真宗般若傳法之堂。	wurde seiner Gedächtnishalle der Name 'Halle der Übertragung der Weisheit der Wahren Schule' verliehen.

七年，	Im 7. Jahr 
¶又賜般若大師之塔。¶	wurde ein weiterer Name verliehen, 'Pagode des Meisters der Weisheit'.
*** 
有僧舉臥輪禪師偈云︰¶
#+BEGIN_VERSE
　臥輪有伎倆，
　能斷百思想。¶
　對境心不起，
　菩提日日長。
#+END_VERSE¶

六祖大師聞之，
曰︰
「此偈未明心地，
若依而行¶之，
是加繫縛因。」
示一偈曰︰¶
#+BEGIN_VERSE

　慧能沒伎倆，
　不斷百思想。¶
　對境心數起，
　菩提作麼長？
#+END_VERSE¶


(此二偈諸方多舉故附於卷末。
臥輪者非名即
住處也)。
¶景德傳燈錄卷第五

¶
